12b	wannabe
2g2b4g	To good to be forgotten
0day	software illegally obtained before it was released
4geit	forget it
2getha	together 
4give	forgive
2trd	too tired
4gai	forget about it
4fs	for f**k's sake
4evs	forever
4evr	for ever
2morrow	tommorrow
4umb	For You Maybe
1sec	one second
4eva	forever
404	Clueless
2morow	tomorrow
4	for
313373	elite
2bh	to be honest
2gethr	together
53x	sex
4ax0r	hacker
2bad4u2	too bad for you too 
2mw	tomorrow
4lyf3	for life
2mz	tomorrow
1daful	wonderful
911sc	emergency let's stop chatting
2ma	Tomorrow
2mo	tomorrow
2ez	too easy
4got	forgot
2maro	tomorrow
2g2bt	too good to be true
4yeo	For Your Eyes Only
2b	to be
1ab	wannabe
2m	tomorrow
2k4	2004
2k5	2005
2k6	2006
2k7	2007
2dae	today
2k1	2001
2k2	2002
2k3	2003
133t	elite
4g8	forget
2k8	2008
2k9	2009
@$$hole	a**h**e
10x	thanks
9009l3	Google
4ward	forward
2day	today
10q	thank you
8008135	boobies
13itch	b***h
3q	thank you
3u	thank you
2getr	Together
2morro	tomorrow
4hoa	four horsemen of the apocalypse
7734	hell
2mmrw	tomorrow
4gv	forgive
2tali	totally
3y3 y4m	I am
1337	elite
304	hoe
4r3al	for real
2moro	tomorrow
?u@	Where are you?
2mora	tomorrow
1nce	once
2mozz	tomorrow
2moz	tomorrow
4wd	forward
2o4s	too old for sex
?up	what's up?
07734	hello
4king	f**king
2k0	2000
301ing	referring traffic to another site
4sho	for sure
2nyt	tonight
2nite	tonight
4e&e	forever and ever
5-oh	cop
4get	forget
2qt	too cute
1dering	wondering
9t	night
0noe	Oh No
4rm	from
5o	police
5n	fine
2	too
187	murder
4ker	f**ker
4lyfe	for life
2h2h	too hot to handle
2m4u	too much for you
80085	Boobs
@$$	a**
31337	elite
2b4u	too bad for you
*eg*	evil grin
2ge4	Together
7uck	f**k
6y	sexy
4ever	forever
2gether	together
4getu	forget you
*67	unknown
@$$ #013	a** hole
2night	tonight
<3	love
@	at
4us	for us
42n8	fortunate
0vr	over
2h4u	too hot for you
6flx	X-Rated movie (sex flick)
4col	For crying out loud
?^	what's up?
4tlog	for the love of god
31ee7	elite
*4u	Kiss for you
^5	high five
10tacle	Tentacle
2da	to the
6up	cops in area
2ditd	today is the day
81tc#	b***h
4311	hell
143	I love you
2tm	to the max
4tw	for the win
5h17	s**t
8008	boob
2l8	too late
2u2	To you too
3vi1	evil
2mro	tomorrow
3arc	Treyarch
4u	for you
4q	f**k you
4n	Phone
4m	form
2mrw	tomorrow
4head	forehead
2sday	tuesday
@h	a**h**e
a/m	away message
a/l	age and location
aiws	as i was saying
anywaz	anyways
anuda	another
alrite	Alright
avie	Avatar
ayec	at your earliest convenience
aup	acceptable use policy
abend	absent by enforced net deprivation
adn	any day now
abt	about
adl	all day long
abft	About f**king Time
alaytm	as long as you tell me
aml	All My Love
ama	ask me anything
aymf	are you my friend
aytf	are you there f**ker
amf	adios motherf**ker
awol	absent without leave
ayty	are you there yet
apu	as per usual
alryt	alright
ayfk	are you f**king kidding
alrt	alright
any1	Anyone
anwwi	alright now where was i
aiamu	and I'm a monkey's uncle
ayst	are you still there
asarbambtaa	All submissions are reviewed by a moderator before they are added.
aiui	as I understand it
absnt	absent
avsb	a very special boy
arsed	bothered
aeap	as early as possible
apreci8	appreciate
a/s/l	age,sex,location
aysm	are you shitting me?
aoys	angel on your shoulder
aboot	about
apod	Another Point Of Discussion
abd	Already Been Done
aatw	all around the world
atst	At the same time
anim8	animate
awsic	and why should i care
asic	application specific integrated circuit
azz	a**
addy	address
aatf	always and totally forever
aybabtg	All Your Base Are Belong To Google
asr	age sex race
anlsx	Anal Sex
aslop	Age Sex Location Orientation Picture
aykm	are you kidding me
asap	as soon as possible
aitr	Adult in the room
atl	atlanta
aybab2u	All your base are belong to us
aight	Alright
ajax	Asynchronous Javascript and XML
aybab2m	all your base are belong 2 me
ase	age, sex, ethnicity
afaiu	As far as I understand
aite	Alright
acc	account
atb	all the best
abreev	abbreviation
ack	acknowledged
ato	against the odds
akpcep	Alexander King Project Cultural Engineering Project
akp	Alexander King Project
alol	actually laughing out loud
atp	answer the phone
anon	anonymous
alot	a lot
atq	answer the question
awk	awkward
aka	also known as
a/s/l/p	age/sex/location/picture
ayt	are you there
a/s/l/r	age, sex, location, race
aty	according to you
aufm	are you f**king mental
afaik	as far as I know
app	application
aybabtu	all your base are belong to us
ayfr	are you for real
afaic	as far as I'm concerned
atw	All the way
api	application program interface
aota	all of the above
avtr	avatar
acct	account
aoto	Amen on that one
atfp	answer the f**king phone
afair	as far as I recall
ayl	are you listening
awsome	awesome
av7x	avenged sevenfold
ayk	are you kidding
ayd	are you done
appt	appointment
aydy	are you done yet
aslrp	age, sex, location, race, picture
ayc	awaiting your comments
ayb	All Your Base
anl	all night long
a$$	a**
aprece8	appreciate
aiadw	ALL IN A DAYS WORK
ayw	as you wish
asl	age, sex, location
amiigaf	ask me if  i give a f**k
ays	are you serious
amsp	ask me something personal
ashl	a**h**e
alotbsol	always look on the bright side of life
a.i.m.	aol instant messanger
awsm	awesome
arse	a**
atop	at time of posting
aslr	age sex location race
aabf	as a best friend
ain't	am not
asbmaetp	Acronyms should be memorable and easy to pronounce
ashole	a**h**e
acgaf	Absolutely couldn't give a f**k
asaik	as soon as I know
aaf	as a friend
azn	asian
ayfkm	are you f**king kidding me
abwt	about
aak	Alive and Kicking
aim	AOL instant messanger
admin	administrator
aypi	and your point is
ar	are
afcpmgo	away from computer parents may go on
aufsm	are you f**king shiting me
attotp	At The Time Of This Post
arnd	around
aiight	all right
attn	attention
azhol	a**h**e
a&f	always and forever
afaiaa	As Far As I Am Aware
a1t	anyone there
atm	at the moment
avy	Avatar
af	assface
ai	Artificial Intelligence
ah	a** hole
afkb	away from keyboard
ayagob	are you a girl or boy
aiic	as if I care
asshle	a**h**e
audy	Are you done yet?
avvie	avatar
anw	anyways
adhd	Attention Deficit Hyperactivity Disorder
aiid	and if I did
afk	away from keyboard
aamof	as a matter of fact
afg	away from game
afc	away from computer
aqap	as quick as possible
ahole	a**h**e
awes	awesome
aoe	Age Of Empires
aoc	age of consent
aob	any other business
amiic	ask me if i care
aon	all or nothing
asafp	as soon as f**king possible
aightz	alright
ayok	are you okay
avgn	Angry Video Game Nerd
ayfs	Are You f**king Serious
a3	anyplace, anywhere, anytime
aos	adult over shoulder
aicmfp	and I claim my five pounds
aaaaa	American Assosciation Against Acronym Abuse
arvo	afternoon
ayte	alright
apoc	apocalypse
aslp	age, sex, location, picture
agn	again
a'ight	alright
afaicr	As Far As I Can Remember
afaics	as far as I can see
afaict	as far as I can tell
alright	all right
aslo	age sex location orientation
burma	be undressed ready my angel
bb4n	Bye-bye for now
bobw	Best of Both Worlds
bb4h	bros before hoes
biznatch	b***h
bich	b***h
butterface	every thing is hot but her face
buwu	breaking up with you
bsxc	be sexy
b82rez	Batteries
bbwe	be back whenever
betch	b***h
byself	by myself
becuse	because
bbwb	best buddy with boobs
bfhd	big fat hairy deal
bbwl	be back way later
butsecks	butt sex
bofh	b*****d operator from hell
bfg	big f**king gun
bff	best friend forever
bfe	Bum f**k Egypt
bfd	big f**king deal
bnr	banner
bubi	bye
bfh	b***h from hell
b/s/l	Bisexual/Straight/Lesbian
bfn	bye for now
bfs	Boyfriends
bruh	brother
bf4l	best friends for life
bm&y	between you and me
bft	big f**king tits
biach	b***h
bout	about
beatch	b***h
bng	being
beotch	b***h
bnib	Brand new in Box
b4u	before you
bbol	be back online later
brt	be right there
bbvl	Be Back Very Later
bii	bye
byoh	bring your own high
blj	blowjob
bmoc	Big Man On Campus
bykt	But you knew that
biz	Business
bestie	best friend
biw	boss is watching
b4n	bye for now
buszay	busy
blnt	Better Luck Next time
bcuz	because
bau	back at you
b.f.f.	best friend forever
bbilfm	be back in like five minutes
bubar	bushed up beyond all recognition
bn	been
bonr	boner
bicbw	but I could be wrong
bwim	by which i mean
bbl8a	Be Back Later
boffum	Both of them
bobfoc	Body of Baywatch, Face of Crimewatch
baf	bring a friend
bab	Big a** Boobs
bbialb	Be back in a little bit
bak	back
bah	I don't really care
bai	Bye
bibi	bye bye
b&	banned
bw3	Buffalo Wild Wings
btwitiailwu	by the way i think i am in love with you
bts	be there soon
btr	better
beeoch	b***h
broseph	brother
bm4l	best mates for life
bty	back to you
bruv	brother
b4	before
btd	bored to death
bzzy	busy
bigd	big deal
bakk	back
btias	Be there in a second
b3	be
btm	bottom
bord	bored
b8	bait
brbigtp	be right back, i got to pee.
btwilu	by the way i love you
btcn	Better than Chuck Norris
byob	Bring your own Beer
bruva	brother
bb	bye bye
b00t	boot
bwpwap	back when Pluto was a planet
bizi	Busy
btsoom	Beats The s**t Out Of Me
b.s.	bulls**t
brbs	be right back soon
biab	back in a bit
brb	be right back
bamofo	b***h a** mother f**ker
bl	bad luck
brbl	be right back later
bleme	blog meme
blh	bored like hell
blk	black
bewbz	boobs
brbf	Be Right Back f**ker
blg	blog
b00n	new person
bfam	brother from another mother
bewbs	boobs
biznitch	b***h
bd	birthday
bf	boyfriend
bg	background
bwt	but when though
bmha	bite my hairy a**
bbim	Be Back In Minute
bc	because
b2w	 Back to work
bm	Bite Me
b2u	back to you
bo	body odour
bh	bloody hell
bj	blowjob
bk	back
bt	bit torrent
bf+gf	boyfriend and girlfriend
br	bathroom
bs	bulls**t
bukket	bucket
b2b	business to business
bz	busy
bruhh	Brother
byeas	good-bye
b@	banned
boxor	box
b8rez	Batteries
brgds	best regards
bos	boss over shoulder
 bi	bye
bbifs	be back in a few seconds
biotch	b***h
bol	Barking Out Loud
bettr	better
bish	b***h
bpot	big pair of tits
bzns	buisness
bsomn	blowing stuff out my nose
b'day	birthday
blogger	web logger
bamf	bad a** mother f**ker
bffaw	best friends for a while
bf's	boyfriend's
bro	brother
btfl	beautiful
bytch	b***h
but6	buttsex
blog	web log
bffae	Best Friends Forever And Ever
brd	bored
bffaa	Best Friends Forever And Always
b0rked	broken
boomm	bored out of my mind
bruz	brothers
bbn	be back never
bbm	BlackBerry Messenger
bbl	be back later
bbk	be back, ok?
brbmf	be right back mother f**ker
bbi	Baby
bbg	baby girl
bbf	best boy friend
bbe	baby
bitd	back in the day
bion	Believe it or not.
bbsts	be back some time soon
bsmfh	b*****d System Manager From Hell
brover	Brother
btdtgtts	Been there, done that, got the T-shirt
bbz	babes
bby	baby
bbiaf	be back in a few
bbw	be back whenever
bblig	Be back later...i guess
bizzle	b***h
bbt	be back tomorrow
bbs	be back soon
b1tch	b***h
bbq	be back quick
bbp	Banned by parents
byak	blowing you a kiss
bma	best mates always
bmf	be my friend
blkm	Black Male
beezy	b***h
buhbi	Bye Bye
babi	baby
byoc	bring our own computer
botoh	but on the other hand
bbrs	be back really soon
bml	bless my life
bfftddup	best friends forever till death do us part
bogsatt	bunch of guys sitting around the table
bezzie	best friend
bttyl	be talking to you later
biatch	b***h
beech	b***h
bhwu	back home with you
betcha	bet you
becuz	because
bstfu	b***h shut the f**k up
bebe	baby
bilf	brother i'd like to f**k
btw	by the way
bcnul8r	be seeing you later
bbbj	Bare Back Blow Job
bmttveot	best mates till the very end of time
budzecks	butt sex
biwm	bisexual white male
beyatch	b***h
bbilb	be back in a little bit
bf4e	best friends for ever
bf4eva	Best Friends forever
bovered	bothered
bilu	baby i love you
btch	b***h
be4	before
b-day	birthday
brbg2p	be right back, got to pee
bljb	Blowjob
brbbrb	br right back bath room break
brbn2gbr	Be right back, I need to go to the bathroom
bbiam	be back in a minute
bibifn	bye bye for now
biaf	Back In A Few
bdfl	Benevolent Dictator For Life
bbfs	best boyfriends
bewt	boot
btb	by the by
bioya	blow it out your a**
bbiab	be back in a bit
bros	brothers
bbfu	be back for you
bffn	best friends for now
bcnu	be seeing you
bffe	Best friends forever
bbfn	Bye Bye for now
bzy	busy
bcurl8	Because you're late.
bffa	best friends for always
bbiaw	be back in a while
bffl	best friends for life
bbias	be back in a second
bogo	buy one get one
boati	Bend Over And Take It
bsod	blue screen of death
btdt	been there done that
boi	boy
brfb	be right f**king back
bewb	boob
b/t	between
bttt	been there, tried that
bizatch	b***h
b/w	between
bmvp	be my valentine please
byes	bye bye
bwoc	Big Woman On Campus
bowt	about
besos	kisses
bohic	Bend over here it comes
bur	p***y
b/c	because
bmay	between me and you
bohica	bend over, here it comes again
b/g	background
brh	be right here
bbtn	be back tonite
btfw	by the f**king way
bsx	bisexual
bka	better known as
bday	birthday
bbml	be back much later
bffeae	Best Friend For Ever And Ever
balz	balls
bstrd	b*****d
bleve	believe
btfo	back the f**k off
bcoz	Because
b4ul	before you Leave
bffene	Best Friends For Ever And Ever
b/cos	because
bch	b***h
b-cuz	because
bck	back
brbts	be right back taking s**t
b4ug	before you go
bytabm	beat you to a bloody mess
bling-bling	jewelry
beyotch	b***h
baggkyko	be a good girl, keep your knickers on
blu	blue
bogof	buy one get one free
bndm3ovr	Bend me over
bmfe	best mates forever
btwn	between
bnol	be nice or leave
bmfl	best mates for life
bfitww	best friend in the whole world
cybr	cyber
cayc	call at your convenience
cybseckz	cyber sex
cut3	cute
cyff	change your font, f**ker
ctpc	cant talk parent(s) coming
cheezburger	cheeseburger
chillin	relaxing
cybl	call you back later
clm	Cool Like Me
cyal	see you later
cm	call me
ctncl	Can't talk now call later
ctnbos	can't talk now boss over shoulder
cr8	crate
cuz	because
cbfa	can't be f**king arsed
cud	could
cym	check your mail
clt	Cool Like That
crakalakin	happening
cuple	couple
cluebie	clueless newbie
cyas	see you soon
chswmrn	come have sex with me right now
c|n>k	coffee through nose into keyboard
cyl8	see you later
crp	crap
cubi	can you believe it
catwot	complete and total waste of time
cod4	call of duty 4
cod5	call of duty 5
cood	could
cskr	c**k sucker
cotm	check out this myspace
cd9	Code 9 (other people nearby)
cex	sex
crs	can't remember s**t
cawk	c**k
cml	call me later
cwtgypo	can't wait to get your panties off
cmh	Call My House
cexy	sexy
cmb	comment me back
cma	Cover My a**
cuzz	Because
cmptr	computer
cmw	cutting my wrists
cmt	comment
cms	content management system
crm	customer relationship management
cfm	come f**k me
copyvio	copyright violation
cless	clanless
cyl8er	see you later
cmbo	combo
cnt	can't
cylbd	catch ya later baby doll
cwmaos	coffee with milk and one sugar
cs:s	Counter-Strike: Source
c2c	care to chat?
cwm	come with me
cnc	Command and Conquer
ctpos	Can't Talk Parent Over Sholder
cwd	comment when done
c-p	sleepy
cwyl	chat with ya later
cpy	copy
c'mon	Come On
cw2cu	can`t wait to see you
culd	Could
comp	Computer
cul8er	see you later
cmplcdd	complicated
cgf	cute guy friend
cfas	care for a secret?
cmcp	call my cell phone
ctt	change the topic
c	see
cts	change the subject
crzy	crazy
coz	because
cmao	Crying My a** Off
cbfed	can't be f**ked
chillax	chill and relax
cob	close of business
cod	Call of Duty
c 2 c	cam to cam (webcams)
code 29	moderator is watching
ctn	can't talk now
col	crying out loud
coo	cool
ch@	chat
chk	check
cn	can
champs	champions
cb	come back
cptn	captain
cg	Congratulations
cuom	see you on monday
cmeo	crying my eyes out
chronic	marijuana
cu46	see you for sex
cmon	Come on
coiwta	come on i wont tell anyone
contrib	contribution
cr	Can't remember
cp	child porn
chswm	come have sex with me
cu	goodbye
ct	can't talk
code 9	Parents are watching
code 8	parents are watching
cyntott	see you next time on Tech Today
c/t	can't talk
cilf	child i'd like to f**k
crunk	combination of crazy and drunk
c@	cat
cwot	complete waste of time
chr	character
c/b	comment back
chu	you
cul83r	See  you later
cml8r	call me later
cgad	couldn't give a d**n
cmliuw2	call me later if you want to
cgaf	couldn't give a f**k
cu2nit	see you tonight
cylor	check your local orhtodox rabbi
cyt	see you tomorrow
c2tc	cut to the chase
cos	because
cul8tr	see you later
chut	p***y
cye	Close Your Eyes
c2	come to
c.y.a	cover your a**
cowboy choker	cigarette
cunt	vagina
cyl	see you later
celly	cell phone
cuic	see you in cla**
ctfu	cracking the f**k up
cul	see you later
cig	cigarette
ciwwaf	cute is what we aim for
contribs	contributions
cid	consider it done
cihyn	can i have your number
convo	conversation
cvq	chucking very quietly
cis	computer information science
cihswu	can i have sex with you
ctfd	calm the f**k down
cam	camera
ctfo	chill the f**k out
cmitm	Call me in the morning
cancer stick	cigarette
cuwul	catch up with you later
cbb	can't be bothered
cigs	cigarettes
cba	can't be arsed
cbf	cant be f**ked
ctrn	can't talk right now
ctrl	control
cfid	check for identification
cbi	can't believe it
char	character
chik	chick
crazn	crazy asian
comin'	coming
curn	calling you right now
cyal8r	see you later
csl	can't stop laughing
csi	Crime Scene Investigation
cyu	see you
cmar	cry me a river
cing	seeing
ctf	capture the flag
c4ashg	care for a shag
comnt	comment
ccna	Cisco Certified Network Associate
chohw	Come Hell or high water
chilax	chill and relax in one word
cs	Counter-Strike
ctc	call the cell
cul8r	See You Later
cof	Crying on the floor
cyl,a	see ya later, alligator
c&c	Command and Conquer
cmplte	complete
compy	computer
c14n	canonicalization
cmiiw	correct me if I'm wrong
cotf	crying on the floor
cpl	Cyber Athlete Professional League
cpm	cost per 1000 impressions
cyb	cyber
code9	other people near by 
cmomc	call me on my cell
congrats	congratulations
cya	goodbye
cre8or	creator
ccl	Couldn't Care Less
ctm	chuckle to myself
cpu	computer
dbi	Don't Beg It
dbh	don't be hating
dgypiab	don't get your panties in a bunch
dbm	don't bother me
daii	day
d.t.f	down to f**k
dgoai	don't go on about it
dbg	don't be gay
damhikijk	Don't Ask Me How I Know - I Just Know
dupe	duplicate
dgms	Don't get me started
d8	date
dillic	Do I look like I care
doncha	Don't you
d2	Diablo 2
dsided	decided
dhac	Don't have a clue
dwb	Driving while black
dju	did you
detai	don't even think about it
dynk	do you not know
dick	penis
dta	Don't Trust Anyone
dya	Do you
dln	don't look now
dmba*	dumba**
dkdc	don't know, don't care
dn	don't know
dl	download
dm	deathmatch
dwmt	don't waste my time
dk	don't know
dh	dickhead
df	Dumb f**k
dg	don't go
dd	don't die
dyw	don't you worry
db	database
dc	don't care
da	the
dat	that
diky	Do I know you
dyk	did you know
diacf	die in a car fire
dw	don't worry
dt	double team
dvda	double vaginal, double anal
deets	details
diku	do i know you
dp	display picture
dil	Daughter in law
din	didn't
dih	d**k in hand
dpmo	don't piss me off
dywtmusw	do you want to meet up some where
ddf	Drug and Disease Free
dgara	don't give a rats a**
dbz	DragonBall Z
diy	do it yourself
dtb	don't text back
dit	Details in Thread
donno	don't know
dnrtfa	did not read the f**king article
dc'd	disconnected
dis	this
diez	dies
dbag	d****ebag
da2	Dragon Age 2
dbab	don't be a b***h
dawg	Friend
duno	don't know
dic	do i care
dhly	does he like you
dtrt	do the right thing
dilligas	do i look like i give a s**t
dlf	dropping like flies
d/l	download
d/m	Doesn't Matter
diaf	die in a fire
d/c	disconnected
dsu	don't screw up
damhikt	don't ask me how I know this
dttm	don't talk to me
dwioyot	Deal With It On Your Own Time
d1ck	d**k
dilligaf	do I look like I give a f**k
dugt	did you get that?
dilligad	do I look like I give a d**n
ddl	direct download
dhcp	Dynamic Host Configuration Protocol
ddg	Drop Dead Gorgeous
d/w	don't worry
dmu	don't mess up
dmaf	do me a favor
du2h	d**n you to hell
doin'	doing
dayumm	d**n
damhik	don't ask me how I know
dr00d	druid
dcw	Doing Cla** Work
dnrta	did not read the article
dirl	Die in real life
dprsd	depressed
dayum	d**n
dunna	i don't know
dugi	do you get it?
dfu	don't f**k up
d.w	don't worry
drm	dream
dontcha	don't you
drc	don't really care
dno	don't know
d&c	divide and conquer
dygtp	did you get the picture
dont	don't
dnimb	dancing naked in my bra
dy2h	d**n you to hell
d&df	drug & disease free
dttriaa	don't tell the RIAA
diff	difference
dwbi	Don't worry about it.
doypov	depends on your point of view
dycotfc	do you cyber on the first chat
dnd	Do Not Disturb
dgaf	don't give a f**k
duk	did you know
dewd	Dude
dum	dumb
dun	don't
dgac	don't give a crap
dctnry	dictionary
dogg	friend
dfw	down for whatever
dnw	Do not want
dnt	don't
dfo	dumb f**king operator
dmwm	don't mess with me
dns	Domain Name System
dgas	Don't give a s**t
dwbh	don't worry, be happy
dlibu	Dont let it bother you
dfc	DON'T f**kING CARE
dilf	dad i'd like to f**k
dbafwtt	Don't Be A Fool Wrap The Tool
d00d	dude
dotc	dancing on the ceiling
dood	dude
dernoe	I don't know
dutma	don't you text me again
dillifc	do I look like I f**king care
dikhed	dickhead
dynm	do you know me
dulm	do you like me
dey	they
dth	down to hang
dtl	d**n the luck
dmi	don't mention it
der	there
dndp	Do not double post
dmn	d**n
dfwmt	Don't f**king waste my time
dafs	do a f**king search
dem	them
dunno	I don't know
dts	Don't think so
dmy	don't mess yourself
dtp	Don't Type Please
ded	Dead
dwai	don't worry about it
def	definitely
deez	these
dylos	do you like oral sex
dass	dumb a**
ddos	Distributed Denial of Service
ducy	do you see why
dftc	down for the count
dttpou	Don't tell the police on us
drood	druid
dwt	don't wanna talk
db4l	drinking buddy for life
dwy	don't wet yourself
d2t	drink to that
dftba	don't forget to be awesome
dyt	Don't you think
d2m	dead to me
dqmot	don't quote me on this
dhv	Demonstration of Higher Value
dwi	deal with it
dwn	down
defs	definetly
din't	didn't
dga	don't go anywhere
dah	dumb as hell
doin	doing
dbeyr	don't believe everything you read
dyth	d**n You To Hell
dats	that's
dylm	do you love me
dfwm	Don't f**k with Me
dfw/m	Don't f**k with Me
dylh	do you like him
dgt	don't go there
dos	denial of service
dyw2gwm	do you want to go with me
dqydj	don't quit your day job
dttml	don't talk to me loser
don	denial of normal
diah	die in a hole
dym	Do you mind
dob	date of birth
dyec	Don't You Ever Care
doa	dead on arrival
dod	Day of Defeat
dyac	d**n you auto correct
ddr	dance dance revolution
dadt	Don't ask. Don't tell.
degmt	Don't Even Give Me That
doodz	dudes
em	them
errythin	everything
eabod	eat a bag of dicks
e.g.	example
eg	evil grin
ef	f**k
ef-ing	f**king
enit	isn't  it
ex-bf	Ex-Boy Friend
eula	end user license agreement
ey	hey
ezi	easy
enat	every now and then
ez	Easy
every1	everyone
efffl	extra friendly friends for life
eleo	Extremely Low Earth Orbit
eq	Everquest
ebitda	earnings before interest, taxes, depreciation and amortization
ehlp	help
elo	hello
eyez	eyes
eotw	end of the world
eejit	idiot
enuff	enough
effin	f**king
evar	ever
esc	escape
ev1	everyone
esl	eat s**t loser
evn	even
esadyffb	eat s**t and die you fat f**king b*****d
esad	eat s**t and die
enuf	enough
ecf	error carried forward
evry1	every one
esbm	Everyone sucks but me
ello	hello
el!t	elite
eot	end of transmission
ead	eat a d**k
etla	extended three letter acronym
e-ok	Electronically OK
evry	every
effed	f**ked
efct	effect
evaa	ever
eedyat	idiot
eoc	end of conversation
eob	End of Business
etp	eager to please
evercrack	Everquest
evrytin	everything
eof	end of file
enof	enough
eod	End of day
emm	email me
eva	ever
emo	emotional
eq2	Everquest2
e4u2s	easy for you to say
eom	end of message
eil	explode into laughter
eos	end of story
ere	here
eta	Estimated Time of Arrival
emp	eat my p***y
exp	experience
edumacation	education
etmda	Explain it to my dumb a**
evr	ever
effing	f**king
ex-gf	Ex-Girl Friend
epa	Emergency Parent Alert
figjam	f**k I'm good, just ask me
fouc	f**k off you c**t 
fmltwia	f**k me like the w***e I am
fo shizzle	for sure
fawk	f**k
fmflth	f**k My f**king Life To Hell
fone	phone
fft	food for thought
ffs	for f**k's sake
ffr	for future reference
fifo	first in, first out
fragged	killed
fwp	first world problems
fo sho	for sure
fify	Fixed It For You
fmfl	f**k my f**king life
ffa	free for all
fvck	f**k
fiv	five
ftf	face to face
foobar	f**ked up beyond all recognition
fym	f**k your mom
fofl	fall on the floor laughing
fio	figure it out
fmnb	f**k me now b***h
fmuta	f**k me up the a**
fwiw	for what it's worth
ftlog	for the love of god
fubb	f**ked up beyond belief
fyf	f**k your face
fmph	f**k my p***y hard
fook	f**k
fub	f**k you b***h
fap	masturbate
faq	frequently asked question
fav	Favorite
fwb	Friends with Benefits
fyl	For your Love
fuhget	forget
fmutp	f**k me up the p***y
fah	Funny as hell
fubr	f**ked Up Beyond Recognition
fao	for attention of
fam	family
fab	fabulous
fbimcl	Fall Back In My Chair Laughing
faa	forever and always
ftk	For the Kill
fus	f**k yourself
fyi	for your information
fnar	For No Apparent Reason
fi9	fine
ftl	For The Lose
fulla	Full of
fnny	funny
ffcl	falling from chair laughing
f4f	female for female
fxe	foxy
f/o	f**k off
f4m	female for male
fbtw	Fine Be That Way
fp	first post
f.b.	facebook
fubalm	f**ked up beyond all local maintenance
foad	f**k off and die
fucktard	f**king retard
ftbfs	Failed to build from source
fyk	for your knowledge
faic	For All I Care
folo	Follow
foss	free, open source software
funee	funny
feck	f**k
foshizzle	for sure
fyad	f**k you and die
ftp	file transfer protocol
fov	Field of View
ftr	For The Record
fsod	frosn screen of death
ftw	For the win!
fos	full of s**t
f4eaa	friends forever and always
ftmp	For the most part
fiik	f**ked If I Know
fyah	f**k you a**h**e
fta	From The Article
fcfs	first come first served
fuctard	f**king retard
ftb	f**k That b***h
fo`	for
foa	f**k off a**h**e
fob	fresh off the boat
fotcl	fell off the chair laughing
fol	farting out loud
fmhb	f**k me hard b***h
flicks	pictures
foo	fool
fcuk	f**k
fotm	Flavour of the month
f.m.l.	f**k my life
fren	friend
fwob	friends with occasional benefits
figmo	F*ck it - got my orders
fgt	faggot
fave	favorite
fgs	for God's sake
ft2t	From time to time
fugly	f**king ugly
fgi	f**king google it
fyrb	f**k you right back
fmah	f**k my a** hole
fiic	f**ked If I Care
fmita	f**k me in the a**
fst	fast
fmao	freezing my a** of
fwm	Fine With Me
fapping	masterbating
fyp	fixed your post
f2f	face to face
flames	angry comments
flamer	angry poster
faggit	faggot
fmir	family member in room
fny	funny
fuk	f**k
fubohic	f**k you Bend over here it comes
f2p	free to play
frens	friends
ftio	fun time is over
f2t	Free to talk
fyfi	For Your f**king Information
fker	f**ker
fu	f**k you
fttp	for the time being
f.u.	f**k you
fmth	f**k me to hell
fkin	f**king
fudie	f**k you and die
fukin	f**king
ferr	For
fmbo	f**k my brains out
fbk	facebook
fmbb	f**k Me Baby
fnpr	for no particular reason
fuxor	f**ker
fuah	f**k you a** hole
fy	f**k you
fk	f**k
fomofo	f**k off mother f**ker
frk	freak
fmr	f**k me runnig
frm	from
fmq	f**k me quick
fmn	f**k me now
fckin	f**king
fml	f**k my life
fer	for
fmh	f**k me hard
fmi	for my information
floabt	for lack of a better term
foia	freedom of information act
fmb	f**k me b***h
f u	f**k you
frgt	forgot
fa-q	f**k you
fye	For Your Entertainment
fnci	fancy
f00k	f**k.
fankle	area between foot and ankle
frag	kill
fumfer	f**k you mother f**ker
fmnkml	f**k me now kiss me later
funner	more fun
fuh-q	f**k you
ffxi	Final Fantasy 11
fut	f**k You Too
fuu	f**k you up
fosho	for sure
fmsh	f**k me so hard
fuq	f**k you
frnd	friend
fuxing	f**king
fuxored	f**ked
fux	f**k
ftfw	For the f**king win!
fwd	forward
fud	fear, uncertainty and doubt
focl	Falling Off Chair Laughing.
fgssu	For Gods sake shut up
fua	f**k you all
ftfa	From The f**king Article
fking	f**king
fsho	for sure
fyb	f**k you b***h
fcking	f**king
fyc	f**k your couch
f8	fate
f9	fine
fukr	f**ker
fukn	f**king
fri.	Friday
f'n	f**king
fya	for your attention
fukk	f**k
fts	f**k that s**t
fibijar	f**k it buddy, I'm just a reserve
fukkin	f**king
fckm3hdbayb	f**k Me Hard Baby
fubah	f**ked up beyond all hope
f4c3	face
fkn	f**king
fyeo	For your eyes only
fka	formerly known as
funy	funny
fashizzle	for sure
fkd	f**ked
fxp	file exchange protocol
f#cking	f**king
fps	First Person Shooter
fubh	f**ked up beyond hope
fpos	f**king piece of s**t
friggin	freaking
fubar	f**ked up beyond all recognition
frnds	friends
fku	f**k you
foaf	friend of a friend
farg	f**k
fs	For Sure
ft	f**k THAT
for sheeze	for sure
foocl	falls out of chair laughing
fitb	fill in the blank
ftlt	For the last time
fsob	f**king son of a b***h
foah	f**k off a**h**e
ftfy	Fixed that for you
fucken	f**king
fc	fruit cake
fe	fatal error
ff	friendly fire
fg	f**king gay
fimh	forever in my heart
fi	f**k it
f&e	forever and ever
fck	f**k
fcbk	facebook
fm	f**k me
fn	first name
fo	f**k off
ftmfw	for the mother f**king win
fckd	f**ked
fcol	for crying out loud
foyb	f**k off you b***h
fsm	flying spaghetti monster
f@	fat
fsr	for some reason
f-ing	f**king
fpmitap	federal pound me in the a** prison
fcku	f**k you
fytd	f**k you to death
fudh	f**k you d**k head
gw	good work
gdr	grinning, ducking, running
gt	get
gdilf	Grandad I'd Like To f**k
glux	good luck
goomh	get out of my head
gsta	Gangster
gu	grow up
gdby	good bye
gg	good game
gf	girlfriend
gd	good
gwijd	guess what i just did
gb	Go back
ga	go ahead
gtty	good talking to you
gdi	God d**n it
gm	good morning
gl	good luck
gj	good job
gh	good half
gta	Grand Theft Auto
gtb	Go To Bed
gsoh	Good Sense of Humor
gmybs	give me your best shot
gtf	get the f**k
gtg	got to go
g3y	gay
gokw	God Only Knows Why
gma	grandma
ghey	gay
ggal	go get a life
gtn	getting
gtp	Got to pee
giyf	google is your friend
gigo	garbage in garbage out
gts	going to school
gb2	go back to
g2gb2wn	got to go back to work now
glnhf	Good Luck and Have Fun
grmbl	grumble
gangsta	gangster
ghei	Gay
gemo	gay emo
gmv	Got my vote
gwork	good work
gtfuotb	get the f**k up out this b***h
g2	go to
g1	good one
g0	go
gd&r	grins, ducks, and runs
gey	gay
glu2	good luck to you too
gsp	get some p***y
g9	good night
g8	gate
g2hb	go to hell b***h
gfe2e	grinning from ear to ear
gbnf	Gone but not forgotten 
gmod	Global Moderator
gl hf	good luck, have fun
g2cu	glad to see you
gtk	good to know
g2/-/	go to hell
g2g4aw	got to go for a while
gba	game boy advance
gfadh	go f**k a dead horse
gjt	good job team
gmfao	Giggling My f**king a** Off
g2g2tb	got to go to the bathroom
gjp	good job partner
gimme	give me
gbu	god bless you
gfurs	go f**k yourself
gsfg	Go search f**king google
gudd	good
gui	graphical user interface
gby	good bye
gfx	graphics
gfy	good for you
gthu	grow the heck up
g2gpp	got to go pee pee
g00g13	Google
gtgbb	got to go bye bye
glbt	Gay, lesbian, bisexual, transgenderd
gfu	go f**k yourself
gfj	good f**king job
gtas	go take a s**t
gfi	good f**king idea
g2gpc	got 2 go parents coming
gfo	go f**k off
gfl	grounded for life
gank	kill
gp	good point
gonna	going to
gfg	good f**king game
gfd	god f**king damnit
gfe	Girl Friend experience
gol	giggle out loud
gdih	Go die in hell
gosad	go suck a d**k
gmabj	give me a blowjob
gagp	go and get pissed
g2bl8	going to be late
good9	goodnite
gthyfah	go to hell you f**king a**h**e
goc	get on camera
gwytose	go waste your time on someone else
gagf	go and get f**ked
gn	good night
gow	gears of war
gjsu	god just shut up
gtfa	Go The f**k Away
gng	going
glty	Good luck this year
gawd	god
g2t2s	got to talk to someone
g2bg	got to be going
giv	give
gotc	get on the computer
gday	Good Day
g2gp	got to go pee
gomb	get off my back
gmao	Giggling my a** off
ggg	Go, go, go! 
gfus	go f**k yourself
gga	good game all
gmtyt	good morning to you too
gtha	go the hell away
gtgfn	got to go for now
gmab	give me a break
gafi	get away from it
gd4u	Good For You
gafl	get a f**king life
gafm	Get away from me
gwm	gay white male
gla	good luck all
gsave	global struggle against violent extremists
glf	group looking for
gy	gay
g2g	got to go
gigig	get it got it good
g2e	got to eat
gewd	good
gws	get well soon
glln	Got Laid Last Night
grvy	groovy
gbioua	Go blow it out your a**
gamez	illegally obtained games
g2h	go to hell
gtfoomf	get the f**k out of my face
gurlz	girls
gngbng	gang bang
gnst	goodnight sleep tight
gtgn	got to go now
gsd	getting s**t done
gtgb	got to go bye
glhf	good luck have fun
gtm	giggling to myself
gnasd	good night and sweet dreams
gnrn	get naked right now
gpb	gotta pee bad
gtgp	got to go pee
gtgtb	got to go to bed
gona	Gonna
g2gs	got to go sorry
*g*	grin
gtfooh	get the f**k out of here
gis	Google Image Search
gir	google it retard
g'nite	good night
gthb	go to hell b***h
grfx	graphics
gn8	good night
gtfon	Get the f**k out noob
gtfoi	get the f**k over it
gtr	Got to run
gl&hf	good luck and have fun
grrl	Girl
g2gb	got to go bye
gaalma	go away and leave me alone
gitar	guitar
gtfu	grow the f**k up
g2ge	got to go eat
gnite	good night
gim	google instant messanger
goin	going
g2gn	got to go now
grtg	Getting ready to go
gfyd	go f**k your dad
gtgpp	got to go pee pee
ggf	go get f**ked
gratz	congratulations
gaw	grandparents are watching
gotcha	got you
gfgi	go f**king google it
gth	go to hell
grats	congratulations
grillz	metal teeth
gpytfaht	gladly pay you tuesday for a hamburger today
gal	get a life
gaj	get a job
gai	gay
gah	gay a** homo
gaf	good as f**k
goml	get out of my life
gork	God only really knows
gdgd	good good
gnstdltbbb	good night sleep tight don't let the bed bugs bite
g2g2w	got to go to work
gnr	Guns n' roses
g2p	got to pee
gyal	girl
gotta	got to
gthmf	go to hell mothaf**ka
g4u	good for you
gr8t	great
gokid	got observers - keep it decent
g4y	good for you
gu2i	get used to it 
gnn	get naked now
gno	going to do
goya	Get Off Your a**
g/f	girlfriend
glwt	good luck with that
geto	ghetto
gtgtpirio	got to go the price is right is on
goyhh	get off your high horse
gfar2cu	go find a rock to crawl under
gnos	get naked on screen
gtsy	good to see you
gtfbtw	get the f**k back to work
gnfpwlbn	good news for people who love bad news
gnoc	get naked on cam
gjial	go jump in a lake
gttp	get to the point
gky	Go kill yourself
gfam	Go f**k A Monkey
gded	grounded
g@y	gay
gfak	go fly a kite
gfad	go f**k a duck
guru	expert
ggpaw	gotta go parents are watching
gdiaf	go die in a fire
gmafb	give me a f**king break
getcha	get you
gwrk	good work
gtgmmiloms	got to go my mum is looking over my shoulder
ggnore	good game no rematch
gtgtwn	Got to go to work now
grl	girl
gnight	good night
gurl	girl
gfas	go f**k a sheep
ggs	good games
gpwm	good point well made
gtfh	go to f**king hell
gtfo	get the f**k out
roflmfao	rolling on the floor laughing my f**king a** off
gcad	get cancer and die
gilf	Grandma I'd like to f**k
grog	beer
gtho	get the hell out
goia	get over it already
gmta	great minds think alike
gud	good
gng2	going to
gmilf	grandmother i'd like to f**k
gsad	go suck a d**k
goi	get over it 
gooh	get out of here!
gdmfpos	god d**n mother f**king piece of s**t
gkys	Go kill yourself
ggp	gotta go pee
gbtw	go back to work
gaoep	generally accepted office etiquette principles
gok	God Only Knows
glu	girl like us
gfym	go f**k your mom
g/g	got to go
gcf	Google Click Fraud
gypo	Get Your Penis Out
gimmie	give me
gr8	great
g2k	good to know
gndn	Goes nowhere,does nothing
gfys	go f**k yourself
gsi	go suck it
hdydi	How do you do it
hax0r	hacker
haxxor	hacker
hbic	head b***h in charge
hi2u2	hello to you too
hdydt	how did you do that
hght	height
hmewrk	homework
hai	hello
hak	here's a kiss
han	how about now
hax0rz	Hackers
hru	how are you
hmus	Hit me up sometime
hrs	hours
h83r	hater
hax	Hacks
hi2u	hello
hakas	have a kick a** summer
hmul	Hit me up later
hsik	how should i know
hre	here
hau	How Are You
hav	have
h4xor	hacker
hiw	husband is watching
hmwk	homework
hyb	how you been
hcib	how can it be
hwmnbn	he who must not be named
hml	hate my life
h/mo	homo
hax0red	hacked
h4x	Hacks
h4xr	hacker
hoopty	broke down automobile
hyg	here you go
hswm	Have Sex With me
h4xx0rz	hacker
h8t3r	hater
hvnt	haven't
hmfic	head mother f**ker in charge
htf	how the f**k
homey	Friend
htc	hit the cell
hppy	Happy
hly	holy
hpybdy	happy birthday
hfsbm	holy f**king s**t batman
hs	headshot
hiybbprqag	copying somebody else's search results
hlo	hello
hbii	how big is it
hlm	he loves me
hll	Hell
htr	hater
hait	hate
http	hyper text transfer protocol
hld	hold
hlb	horny little b*****d
hla	Hot lesbian action
heyy	hello
hijack	start an off topic discussion
h/w	homework
huggle	hug and cuddle
h.o	hold on
h&k	hugs and kisses
hcbt1	he could be the one
h8red	Hatred
h2gtb	have to go to the bathroom
hcihy	how can I help you
hhyb	how have you been
haxer	Hacker
h8u	I Hate You
hsd	high school dropout
hb4b	hoes before bros
habt	how about this
h4xrz	hackers
hl2	Half-Life 2
hsr	homestar runner
hss	horse s**t and splinters
hwik	how would i know
hthu	Hurry the hell up
heyt	hate
hldon	hold on
hhiad	holy hole in a doughnut
haxzor	hacker
hnic	head n****r in charge
hbd	happy birthday
htfu	Hurry the f**k up
hrny	horny
hammrd	hammered
hhok	Ha Ha Only Kidding
hby	how about you
hbu	how about you
hith	how in the hell
haxz0r	Hacker
haxoring	hacking
hpoa	Hot Piece of a**
h8	hate
h9	Husband in Room
h2	Halo 2
hve	have
h8ed	hated
hmwrk	Homework
hyk	how you know
hwmbo	he who must be obeyed
h8er	hater
h4x0r	hacker
hrud	how are you doing
hott	hot
howdey	hello
h8tr	hater
h8t0r	hater
homo	homosexual
h4xxor	hacker
hwms	hot wild monkey sex
hiya	hello 
heh	haha
h8te	hate
h4kz0r5	hackers
hud	Heads Up Display
hy	hell yeah
hdop	Help Delete Online Predators
hr	hour
haxorz	hackers
hun	honey
hmw	homework
hv	have
hw	homework
ht	Heard Through
hu	Hey you
hj	hand job
haxor	hacker
hl	Half-Life
hb	hurry back
hc	how come
hlp	help
hf	have fun
hg	HockeyGod
hmb	hold me back
hdu	how dare you
h/e	However
hng	horny net geek
hlysht	Holy s**t
hoay	how old are you
h/o	hold on
hhiadb	Holy Hole in a Donut Batman
hngry	hungry
heya	hey
h8s	hates
h8r	hater
h/u	hold up
hayd	how are you doing
h8t	hate
havnt	haven't
heyya	hello
hfwt	have fun with that
haxors	hackers
h2sys	hope to see you soon
h+k	hugs and kisses
homie	good friend
haxxzor	Hacker
h3y	hey
hmoj	holy mother of jesus
hxc	hardcore
hldn	hold on
hoas	Hang on a second
hth	hope that helps
hom	home
hiet	height
hoh	head of household
hella	very
hmu	Hit Me Up
hw/hw	help me with homework 
hpb	high ping b*****d
hwga	here we go again
hafta	have to
hugz	hugs
hawt	hot
hwk	homework
h*r	homestar runner
hwg	here we go
hpy	happy
hwz	how is
hawf	Husband and Wife forever
hawtie	hottie
hwu	hey what's up
h82sit	hate to say it
hiik	Hell If I Know
hagd	have a good day
h80r	hater
howz	hows
hfs	holy f**king s**t!
hagl	have a great life
hagn	have a good night
hago	have a good one
h2o	water
hags	have a great summer
hfn	Hell f**king no
hubby	husband
ho	hold on
itc	in that case
ilysmydek	I Love You So Much You Don't Even Know
ibbl	I'll be back later
im26c4u	I am too sexy for you
imma	I'm going to
icsrg	I can still reach Google
init	isn't it
idwtg	I don't want to go
ilysm	i love you so much
innit	isn't it
iyd	In Your Dreams
ilylas	i love you like a sister
instagib	instant kill
iebkac	issue exists between keyboard and chair
ilylab	I love you like a brother
idtkso	i don't think so
icp	insane clown posse
iym	I am your man
iwtfy	i want to f**k you
inbd	it's no big deal
i8u	i hate you
i<3u	I love you
intpftpotm	I nominate this post for the post of the month
idts	i don't think so
ihusb	i hate you so bad 
idlyitw	i don't like you in that way
irhy	i really hate you
idkh2s	i don't know how to spell
ihusm	i hate you so much
imvho	in my very humble opinion
iw2f	i want to f**k
ihusfm	i hate you so f**king much
iois	Indicators of Interest
ilms	I love my self
ilml	I Love My Life
ijgl	I just got laid
inb4	in before
idkymb2	I didn't know yoru mom blogs too
idfts	I don't f**king think so
irhtgttbr	I really have to go to the bathroom
iykwim	if you know what I mean
iunno	I don't know
iwsul8r	I will see you later
ians	I am Not Sure
ily4e	i love you forever
ianalb	I am not a lawyer, but..
ilylabf	I love you like a best friend
inef	it's not even funny
irdgaf	i really don't give a f**k
inhwh	I need homework help
inet	internet
iit	is it tight
ih8tu	i hate you
ihysmrn	i hate you so much right now
ihya	i hate you all
ik	i know
iss	im so sorry
ibs	Internet b***h Slap 
ibt	I'll be there
iwaa	It was an accident
ibw	I'll be waiting
iucmd	if you catch my drift
indie	independent
ilysmih	i love you so much it hurts
imhbco	In my humble but correct opinion
irly	I really love you
inho	in my honest opinion
iawy	I agree with you
icudk	in case you didn't know
ih8usm	i hate you so much
iwythmb	i want you to have my baby
iono	I don't know
idn	i don't know
isj	inside joke
imwtk	Inquiring minds want to know
ilybtid	I Love You But Then I Don't
imysfm	i miss you so f**king much
iiwii	it is what it is
ianabs	I am not a brain surgeon
isb	I'm so bored.
ind2p	I need to pee
idfk	i don't f**king know
ityltk	I thought you'd like to know
ilvu	i love you
iuno	i dunno
imnl	I'm not laughing
idkwiwdwu	I don't know what I would do without you
ise	internal server error
idkbibt	I don't know but I've Been Told
idgara	I don't give a rat's a**
imts	I meant to say
itn	I think not
itk	in the know
itd	in the dark
icydk	in csae you didn't know
itb	in the butt
imfao	In My f**king Arrogant Opinion
icbt	i can't believe that
icbu	I can't believe you
icbi	i can't believe it
itz	it's
itt	in this thread
iluwamh	i love  you with all my heart
ima	I am a
imb	I am back
imh	I am here
imm	instant message me
imo	in my opinion
igtkya	im going to kick your a**
ilhsm	i love him/her so much
imy	I miss you
imsry	I am sorry
ilotibinlirl	I'm laughing on the internet, but I'm not laughing in real life
idtis	I don't think I should
iukwim	if you know what i mean
imnshmfo	In My Not So Humble Mother f**king Opinion
iokiya	it's ok if you are
ibtl	In Before The Lock
icymi	in case you missed it
ita	I Totally Agree
iigh	alright
ifttt	if this then that 
itzk	it's ok
ifwis	I forgot what I said
iff	if and only if
imya	i miss you already
ifk	I f**king know
iwjk	i was just kidding
i<3 u	i love you
idek	 I don't even know
iydhantsdsaaa	If you don't have anything nice to say don't say anything at all
idec	I don't even care
iasb	i am so bored
ilbbaicnl	I like big butts and I can not lie
ionno	I don't know
invu	I envy you
ilum	i love you more
idby	I Don't Believe You
imnsho	in my not so humble opinion
ih2p	i'll have to pa**
iai	i am interested
ilu2	I love you too
iawtp	I agree with this post
intarwebs	internet
isp	internet service provider
id10t	idiot
iiuc	if I understand correctly
ilk2fku	I would like to f**k you
iso	In Search Of
imnerho	In my not even remotely humble opinion
iawtc	I agree with this comment
isg	I speak geek
inttwmf	I am Not Typing This With My Fingers
isd	internet slang dictionary
ihy	i hate you
idfc	i don't f**king care
ih8mls	I hate my little sister 
idw2	I don't want to
iht	I heard that
ihu	I hate you
iydmma	if you don't mind me asking
iafh	I Am f**king Hot
iafi	I am from India
iwfusb	i wanna f**k you so bad
iwsn	i want sex now
igtgt	I got to go tinkle
iah	i am horny
iag	it's all good
iab	I Am Bored
ilysfm	i love you so f**king much
iotd	image of the day
iaw	In Another Window
iap	I Am Pissed
ikwud	I know what you did
ih8	i hate
imy2	i miss you to
instakill	instant kill
icty	i can't tell you 
idwt	i don't want to
idwk	I don't wanna know
idlu	i don't like you
idly	I don't like you
iluaaf	i love you as a friend
ilykthnxbai	i love you k thanks bye
idli	I don't like it
ifthtb	i find that hard to belive
icwudt	I see what you did there
ilysvm	i love you so very much
idrgaff	i don't really give a flying f**k
irdk	I really don't know
idkwts	I don't know what to say
irdc	I really don't care
iight	alright
iwhswu	I want to have sex with you
imoo	in my own opinion
iistgtbtipi	If It Sounds Too Good To Be True It Probably Is
ikwum	I know what you meant
istr	I seem to remember
iwg	it was good
iwc	In Which Case
iwk	I wouldn't know
iwu	i want you
iws	i want sex
ilulafklc	I love you like a fat kid loves cake.
iyswim	if you see what I mean
iwlu4e	I will love you for ever
iwy	i want you
ianyl	I am not your lawyer
iwfybo	i will f**k your brains out
ijcomk	i just came on my keyboard
iwbrbl@r	I will be right back later
idgaff	I don't give a flying f**k
idnwths	i do not want to have sex
ilywamh	I love you with all my heart
ijeomk	I just ejaculated on my keybord
idgafs	I don't give a f**king s**t
incrse	increase
igyb	I Got Your Back
iiok	is it okay
iitywybmad	if I tell you, will you buy me a drink?
iwtly	i want to love you
ihtfp	I hate this f**king place
idsw	i don't see why
iygm	if you get me
iflu	i f**king love you
ite	alright
iatb	I am the best
isianmtu	I swear I am not making this up
idw2n	i don't want to know
ijaf	it's just a fact
icydn	in case you didn't know
im'd	instant messaged
irc	internet relay chat
ietf	internet engineering task force
ih8u	I hate you
ih8p	I hate parents
ih8y	I hate you
imho	in my humble opinion
imhe	in my humble experience
iccl	I could care less
iirc	if I recall correctly
irt	in reply to
iwyb	I want your body
irl	in real life
imsb	i am so bored
idky	I don't know you
iwyn	I want you now
ikr	I know really
i <3 u	I love you
iki	i know it
ikm	I know man
ioyk	if only you knew
ioya	I'd Own Your a**
ili	i love it
ilu	I love you
ily	i love you
iluvu	i love you
icup	i see you pee
ikwyl	I know where you live
idjit	idiot
iluvm	I Love You Very Much
ilyaas	I Love You As A Sister
iw2fu	i want to f**k you
idop	it depends on price
iyflg	If You're Feeling Less Generous
ihat3u	I hate you
ianal	I am not a lawyer
ijsabomomcibstg	I just saved a bunch of money on my car insurance by switching to geico
imu	i miss you 
iiw2	is it web 2.0?
ifhy	i f**king hate you
imao	in my arrogant opinion
iddi	I didn't do it
ifhu	I f**king hate you
ig2g	I got to go
idrts	I don't really think so
isbya	im sorry but you asked
ihnc	i have no clue
iyf	In your face
iyc	if you can
ihni	i have no idea
idntk	i dont need to know
iyo	in your opinion
ilyvm	i love you very much
iltf	i love to f**k
ihiwydt	I hate it when you do that
iyq	I like you
ive	i have
iz	is
ip	internet protocol
ilshipmp	I laughed so hard I peed my pants
ih	it happens
ilyb	i love you b***h
ij	indide joke
im	Instant Message
ilyf	I'll Love You Forever
ight	alright
ic	I see
ib	I'm back
ilyl	i love you loads
ilym	 i love you more
ig	I guess
ianars	I am not a rocket scientist
ih2gp	I have to go pee
isfly	i so f**king love you
i8	alright
ily2	i love you too
iow	in other words
iou	i owe you
iateu	i hate you
igt	I Got This
ioh	I'm out of here
idrfk	I don't really f**king know
ikt	i knew that
icbyst	i cant believe you said that
idke	I don't know ethier
ishii	i see how it is
iwhi	I would hit it
idkh	I don't know how
igahp	I've got a huge penis
idkw	I don't know why
idkt	I don't know that
ihtp	I Have To Poop
is2g	i swear to god
ilybby	i love you baby
iwuwh	i wish you were here 
ikwym	i know what you mean
idunno	i do not know
i c	i see
idbtwdsat	I don't believe they would do such a thing
iw2mu	I want to meet you
ijit	idiot
ihistr	i hope i spelled that right
icic	I See. I See
ilusfm	I love you so f**king much
ihmp	i hate my parents
ihml	I hate my life
imed	instant messaged
ibcd	Idiot between chair & desk
intel	intelligence
interweb	internet
icbiwoop	I chuckled, but it was out of pity.
ilbcnu	i'll be seeing you
idkwurta	I don't know what you are talking about.
ijp	Internet job posting
ijr	i just remembered
igtg	i've got to go
ilymtylm	i love you more than you love me
idgac	i don't give a crap
idgad	I don't give a d**n
idgaf	i don't give a f**k
ihnfc	I have no f**king clue
istwfn	I stole this word from noslang.com
ijf	i just farted
ihtutbr	I have to use the bathroom
idgas	i don't give a s**t
icb	I can't believe
irgtgbtw	I've really got to get back to work
ilylc	i love you like crazy
iwmu	i will miss you
iwtfu	i want to f**k you
icr	I can't rememer
idonno	i do not know
icw	I care why?
icu	i see you
ilusm	I love you So much
ilysmm	i love you so much more
iavb	i am very bored
idyat	idiot
impov	in my point of view
ily4ev	i love you forever
ihurg	i hate your guts
idrk	i don't really know
iywt	if you want to
idot	idiot
idrc	i don't really care
idr	I don't remember
icwum	I see what you mean
idl	I don't like
idm	I don't mind
idk	I don't know
ilysfmb	i love you so f**king much baby
imcdo	in my conceited dogmatic opinion
idc	I don't care
idgi	I don't get it
imfo	in my f**king opinion
ianacl	I am not a copyright lawyer
ijpmp	I just peed my pants
ijpms	I just pissed myself
ihac	I have a customer
ictrn	I can't talk right now
inmp	it's not my problem
iitywimwybmad	if I tell you what it means will you buy me a drink
incld	include
ihtsm	i hate this so much
iswydt	i see what you did there
icgup	I can give you pleasure
ihysm	I hate you so much
idkyb	i don't know why but
impo	In My Personal Opinion
iluvya	i love you
ilcul8r	I'll see you later
ino	I know
inh	I need help
ilyal	I like you a lot
iduwym	I don't understand what you mean.
iyam	if you ask me
ilymtyk	i love you more than you know
igu	i give up
ijk	I'm Just kidding
igs	I guess so
imusm	I miss you so much
ihtgttbwijd	I have to go to the bathroom, wait I just did.
irtf	I'll return the favor
igg	i gotta go
iwfy	I want to f**k you
idrgaf	I don't really give a f**k
igalboc	I've got a lovely bunch of cocnuts
ig5oi	I got 5 on it 
in2	into
ilylafklc	i love you like a fat kid loves cake
imtaw	it may take a while
iwmy	i will miss you
iyss	if you say so
ijdk	I just don't know
iwthswy	i want to have sex with you
ijdl	I just died laughing
idno	i do not know
ilygsm	i love you guys so much
idnk	i don't know
igkymfa	I'm gonna kick your mother f**king a**
idkwym	I don't know what you mean
juss	just
jttsiowctw	just testing to see if other websites copy this word
jizz	semen
jst	just
jgtfooh	just get the f**k out of here
jtty	just to tell you
j-c	just chilling
jwtlyk	Just wanted to let you know
jic	just in case
jas	just a second
jit	just in time
jtol	just thinking out loud
jtoi	just thought of it
jtfo	joke the f**k out
jw2k	just wanted to know
jdfi	Just f**king do it
j4u	just for you
jhm	just hold me
jho	just hanging out
jcath	Just chilling at the house
j4l	just for laughs
jgiyn	Just google it you noob
j4g	just for grins
j4f	just for fun
jlt	just like that
jalaudlm	just as long as you don't leave me
jtyltk	just thought you'd like to know
jwas	just wait a second
jsa	just stop already
juzt	just
jtysk	just thought you should know
jtc	Join the club
jfwy	just f**king with you
j2f	just too funny
jw	just wondering
j2c	just too cute
jcam	just checking away message
jp	just playing
j2lyk	just to let you know
js	just saying
jm	Just Messing
jh	Just hanging
jj/k	just joking
jk	just kidding
jf	just fooling
jom	just one minuite
jb	jailbait
joo	you
jfk	Just f**king kidding
jfj	jump for joy
jfi	just forget it
jtlyk	just to let you know
jfo	just f**k off
jfn	just for now
jfl	just for laughs
jfc	Jesus f**king Christ
jklol	Just Kidding Laughing Out Loud
jfg	just for giggles
jff	just for fun
jsing	just saying
jlma	just leave me alone
jfr	Just for reference
jfu	just for you
jtay	just thinking about you
jtwiw	just the way it was.
jj	just joking
jtluk	just to let you know
j00	you
jtwii	just the way it is.
jja	just joking around
jking	joking
jc	just curious
jfgi	just f**king google it
jtbs	Just To Be Sure
jg2h	just go to hell
jms	just making sure
jbu	just between us
jus	just
jmo	just my opinion
jml	just my luck
juz	just
jma	just messing around
jsyn	just so you know
jsyk	Just so you know
jumping the couch	acting strange
j/p	just playing
jftr	just for the record
j/s	just saying
j/t	just talking
jsut	just
j/w	just wondering
jtumltk	just thought you might like to know
j/a	Just Asking
j/c	just curious
jsuk	just so you know
j/j	just joking
j/k	just kidding
jsun	Just so you know
j/o	jackoff
j2bs	just to be sure
j2luk	just to let you know
jeomk	Just ejaculated on my keyboard
j00r	your
jooce	Juice
jkz	jokes
jks	jokes
jkl	just kidding loser
jkn	joking
jka	just kidding around
jyfihp	jam your finger in her p***y
joor	your
jebus	Jesus
jooc	just out of curiosity
jfdi	Just f**king Do It!
jflts	just felt like typing something
kmn	kill me now
kmfa	kiss my f**king a**
kthxbye	ok, thank you, goodbye
kss	kiss
kthnxbye	Okay, thanks, bye
knackered	drunk
kkthnxbye	okay thanks bye
kisa	knight in shining armor
khuf	know how you feel
kthanxbi	Okay, thanks. Bye.
kyfc	keep your fingers crossed
kitteh	kitten
kkk	ku klux klan
kthx	ok, thank you
kthz	ok thanks
kwtsds	Kiss where the sun don't shine
kcco	keep calm chive on
kpc	keeping parents clueless
kmb	kiss my butt
kma	kiss my a**
kuwl	cool
kml	Killing Myself Laughing
kul	cool
kmp	kill me please
kafn	kill all f**king noobs
ktfo	knocked the f**k out
kek	laughing out loud
kool	cool
kthxbai	ok thanks bye!
kit	keep in touch
k	ok
kitfo	knock it the f**k off
ktnx	Okay and Thanks
kthxgb	ok thanks goodbye
kewel	cool
kinda	kind of
kwl	cool
kfc	kentucky fried chicken
kyag	Kiss Your a** Goodbye
kay	okay
kyko	keep your knickers on
kol	kiss on lips
koo	cool
kewl	cool
kos	kid over shoulder
kmao	kick my a** off
kthxmn	Ok Thanks Man
kb	KiloBite
kotor	Knights of the old republic
knewb	new player
kmag	kiss my a** goodbye
kots	keep on talking s**t
kiwf	Kill It With Fire
kotl	kiss on the lips
kutgw	Keep Up The good Work
kicks	sneakers
khitbash	kick her in the box and shove her
kotc	kiss on the cheek
kmswl	killing myself with laughter
kuhl	cool
kiled	killed
ktc	kill the cat
kwim	Know What I Mean
k3wl	cool
kmsl	killing myself laughing
kwik	quick
kwit	quit
kwis	Know what I'm saying?
kute	cute
kys	kill yourself
kky	kinky
kthnxbai	Okay, thanks, bye
kwiz	quiz
kthxbi	ok, thank you, goodbye
kyfag	kiss your f**king a** goodbye
kis	keep it simple
kir	kid in room
kah	kisses and hugs
kiu	Keep it up
kssd	kissed
kaw	kick a** work
kmhba	kiss my hairy big a**
kic	keep it clean
kib	okay, im back
kia	Killed In Action
kig	keep it going
knn	f**k your mother
kno	know
ka	Kick a**
kk	ok
ko	knock out
km	kiss me
kl	cool
ks	kill steal
kt	keep talking
knw	know
lyke	like
l8t	later
l8s	later
l8er	later
lazor	laser
lmaol	laughing my a** out loud
ltns	long time no see
lmaonade	laughing my a** off
ldr	Long-distance relationship
lawl'd	laughed out loud
lmaomtoaoa	Laugh my a** off many times over and over again
l8a	later
lolbs	laugh out loud but seriously
l8ter	later
ltb	looking to buy
llf	laugh like f**k
liita	love is in the air
l8r	see you later
lf	looking for
lrfl	Laughing really f**king loud
loti	laughing on the inside
latr	Later
ln	last name
lcsnpc	low cost small notebook personal computer
lke	like
lf1m	Looking for one more
lk	like
lltnt	live like theres no tomorrow 
lv	love
lorl	laugh out real loud
lt	long time
lmso	laughing my socks off
lata	later
l8ers	Later
luvv	love
lirl	laughing in real life
lylad	love you like a dad
latn	laugh at the newbs
loxxen	laughing out loud
ltnt	long time no talk
ly	love you
ltms	Laughing to my self
loxen	laughing out loud
lsr	loser
luzar	Loser
lmto	laughing my tits off
lolngs	laghing out loud never gonna stop
lrh	laughing really hard
lzr	loser
lyfao	laughing your f**king a** off
lmtd	limited
lmmfao	laughing my mother f**king a** off
ligaff	like I give a flying f**k
lm4aq	Let's meet for a quickie.
lezbo	lesbian
lmmfas	laugh my mother f**kin a** off
lrt	last retweet
lololz	laugh out loud
lshic	laughing so hard i'm crying
ligafs	like I give a flying s**t
lysm	love you so much
lfnar	laughing for no aparent reason
lurve	love
liu	Look It Up
lmhao	laughing my hairy a** off
luk	look
lpms	life pretty much sucks
l8ta	later
liekz	likes
loflmao	laying on floor laughing my a** off
lvya	love you
lul	love you lots
lvl	level
llol	literally laughing out loud
lylaba	love you like a brother always
lol2u	Laugh out loud to you
lqtms	Laughing quietly to myself
l2	learn to
lyt	love you too
l8tr	later
lolq	laugh out loud quietly
lmbao	laughing my black a** off
lmbfwao	laughing my big fat white a** off
lulz	Laughing out loud.
l8	late
lmffao	laughing my f**king fat a** off
lolci	laughing out loud, crying inside
lmsao	laughing my sexy a** off
lfg	Looking for group
lu2d	love you to death
lhao	laughing her a** off
lylno	Love you like no other
lfm	looking for mate
lfl	let's f**k later
lmamf	leave me alone mother f**ker
l2m	listening to music
lolcity	the whole city laughs out loud
liol	laugh insanely out loud
l2p	learn to play
lmkwut	let me know what you think
l2r	Learn to read
lezzzie	lesbian
lfp	looking for p***y
lnk	Link
lfr	Laughing for real
lollerskates	laughing out loud
lshipmp	Laughing so Hard I Piss My Pants
lolarotf	laughing out loud and rolling on the floor
lmbo	laughing my butt off
larp	live action role-play
lolf	lots of love forever
luv	love
lold	laughed out loud
l84skool	late for school
lollercaust	an extreme event of hilarity
lyvm	love you very much
lrqtms	laughing really quietly to myself
lmmfaos	laughing my mother f**king a** off silly
lmgtfy	Let me Google that for you
lolm	laugh out loud man
ltnc	Long time no see
lols	laugh out loud 
leik	like
l33t	elite
loto	laughing on the outside
luf	love
lug	lesbian until graduation
lolz	laugh out loud
lsfw	Less Safe For Work
lappy	Laptop
lolees	laugh out loud
lotf	laughing on the floor
lol'd	laughed out loud
lolwtime	laughing out loud with tears in my eyes
lobfl	Laugh Out Bloody f**king Loud
lub	laugh under breath
lmfao	laughing my f**king a** off
lmvo	laugh my vagina off
lms	leave me some
lmp	lick my p***y
lolrotf	laughing out loud rolling on the floor
lmclao	laughing my cute little a** off
ltywl	love the way you lie
lawlz	laughing out loud with a southern drawl
lml	love my life
lylafklc	love you like a fat kid loves cake
latwttb	laughing all the way to the bank
liyf	laughing in your face
lma	leave me alone
lez	Lesbian
lalol	lots and lots of laughs
lesbo	lesbian
lmap	leave me alone please
legit	legitimate
lmfpo	laughing my f**king p***y off
ltr	later
lu2	love you too
lol	laughing out loud
ltw	Lead The Way
lmirl	Let's meet in real life
lomg	like oh my god
lmb	lick my balls
loomm	laughing out of my mind
lolvq	laugh out loud very quietly
loml	love of my life
llab	Laughing like a b***h.
l0lz	laugh out loud
l337	elite
lasb	Lame a** Stupid b***h
lmk	let me know
lttpot	laughing to the point of tears
lawled	laughed out loud
lwn	last week's news
lmoao	Laughing my Other a** Off
ltm	listen to me
llap	live long and prosper
lolaw	laugh out loud at work
liec	like i even care
lurker	one who reads but doesn't reply
lshismp	laughed so hard I s**t my pants
lmaowtntpm	laughing my a** off whilst trying not to piss myself
liek	like
lggd	let's go get drunk
lmo	Leave Me One
lysfm	love you so f**king much
lmip	LETS MEET IN PERSON
lmaorotf	laughing my a** off rolling on the floor
lat	laugh at that
limh	laugh in my head
lshid	laugh so hard i die
lovu	love you
lf2m	looking for 2 more
l2ms	laughing to myself
less than 3	love
lawls	laughing out loud with a southern drawl
lmaowrotf	Laughing my a** of while rolling on the floor
lgot	let's go out tonight
lymi	love you mean it
lof	Laughing on floor
lol@u	Laugh out loud at you
lolocost	laugh out loud
lorrl	laugh out really really loud
lmd	Lick My d**k
loi	laughing on the inside
lhsrn	let's have sex right now
lvr	lover
lov	love
lmaorof	Laughing my a** off Rolling on the floor
lusm	love you so much
lmffo	Laughing my f**king face off
lmgdao	Laughing My God d**n a** Off
lmg	let me guess
luff	Love
lemme	let me
lolerz	laugh out loud
lolio	laugh out loud I own
lollam	Laughing Out Loud Like A Maniac
lgn	link goes nowhere
lgo	life goes on
l4m3rz	lamers
lolin	laughing out loud
lgb	lesbian/gay/bisexual
lq	Laughing Quietly
lmpo	laughing my panties off
less than three	love
lgf	little green footballs
lulab	Love you like a brother
lmaool	laughing my a** off out loud 
lulas	Love You Like a Sister
lmho	laughing my heiny off
ltp	Lay the pipe
lmmffao	laughing my mother f**king fat a** off
lgr	little girls room
lgs	let's go shopping!
lu4l	love you for life
lofl	laugh out f**king loud
lshrn	laughing so hard right now
ltip	laughting until I puke
lsudi	Lets see you do it
lmao	laughing my a** off
lzer	laser
lmcao	laughing my crazy a** off
lukin	looking
lyfe	life
lq2m	laughing quietly to myself
lve	Love
lollercoaster	laugh out loud (a lot)
luvuvm	love you very much
lmks	Let Me Know Soon
lazer	laser
l@u	laughing at you
lvn	loving
lmtus	let me tell you something
lmaoxh	laughing my a** off extremely hard
lofi	uncool
luver	lover
lbr	little boy's room
lgbnaf	lets get butt naked and f**k
lpiaw	Large Penis is always welcome
l8rz	later
leme	let me
ltmq	Laugh To Myself Quietly
lolol	saying "lol" out loud
lmaootf	Laughing my a** off on the floor 
lyf	life
lybo	laugh your butt off
lya	love you always
lyl	love you lots
lbh	let's be honest
lmfbo	laugh my f**king butt off
lbo	laughing butt off 
lyk	like
lmfr	Lets Meet For Real
lbnr	laughing but not really
lamf	like a motherf**ker
lylas	I love you like a sister
lic	like i care
lil	little
lim	Like it Matters
lozer	loser
lih	Laugh in head
lik	like
lifo	last in first out
liv	live
lolcano	laugh out loud
ligas	like I give a s**t
lqts	laughing quietly to self
lylab	love you like a brother
luser	user who is a loser
lmfo	laughing my face off
lyaaf	Love you as a friend
lal	laughing a little
lam	leave a message
lan	local area network
lmfto	laughing my f**kin tits off
lmtfa	leave me the f**k alone
ly2	love you to
lak	love and kisses
llc	laughing like crazy
lgbtq	Lesbien, Gay, Bisexual, Transgender and Queer.
lmfho	laughing my f**king head off
leet	elite
lylasa	love you like a sister always
lylam	love you like a mom
lyaab	Love you as a brother
lomy	love of my life
lezbean	lesbian
lau	laugh at you
lshiwms	laughing so hard I wet myself
lolpimp	Laughing out loud peeing in my pants
lthtt	laughing too hard to type
lawl	lauging out loud with a southern drawl
lee7	elite
loln	laught out loud... not
lyk3	like
l8rs	laters
lyls	love you lots
lshmson	laughing so hard milk shot out nose
lawd	lord
lates	later
lafs	love at first sight
lyao	laugh your a** off
lolrof	Laughing out loud while rolling on the floor.
lqtm	Laugh quietly to myself
ltnsoh	Long time, no see or hear
lhs	lets have sex
lotr	lord of the rings
lmty	laughing more than you
laff	laugh
lbvs	laughing but very serious
lwih	look what I have
lpb	low ping b*****d
lsmih	laughing so much it hurts
lj	live journal
mfa	mother f**king a**h**e
mfb	mother f**king b***h
myspce	myspace
messg	message
mfg	merge from current
mnt	More next time
mtfbwu	may the force be with you
milf	Mom i'd like to f**k
mfr	motherf**ker
miwnlf	mom I would not like to f**k.
mfw	my face when
msgs	messages
meatcurtain	woman's private parts
mmas	meet me after school
myfb	mind your f**king business
mtrfkr	motherf**ker
mof	matter of fact
mty	empty
mwf	Married White Female
mmiw	my mom is watching
m4m	male for male
m4f	male for female
mastrb8	masturbate.
mpd	Multiple Personality Disorder
mbfal	my best friend and lover
mos	mom over shoulder
mor	more
mph	miles per hour
moh	Medal Of Honor
mol	more or less
mlia	my life is amazing
mayte	mate
mw3	Modern Warfare 3
mho	My Humble Opinion
mhm	Yes
mbl8r	Maybe Later
mhh	my head hurts
mstrb8r	masturbator
mb	my bad
masterb8	masterbate
mfkr	motherf**ker
m84l	mate for life
mmmkay	okay
mw2	modern warfare 2
mnm	eminem
motos	member of the opposite sex
myke	man-dyke
me2	me too
mthrfkr	mother f**ker
msibo	my side is busting open
mysm	Miss you so much
motarded	more retarded
mul	miss you lots
msie	microsoft's internet explorer
mwah	kiss
mompl	moment please
mypl	my young padawan learner
mtherfker	mother f**ker
mmt	meet me there
mmw	making me wet
meh	whatever
mmatp	meet me at the park
mml	making me laugh
mkay	ok
mmk	umm, ok
mmd	make my day
mite	might
mmatc	meet me around the corner
muvva	mother
mmamp	Meet me at my place
mego	my eyes glaze over
mfah	motherf**king a**h**e
mfao	my f**king a** off
mofo	mother f**ker
mmbocmb	message me back or comment me back
m'kay	okay
mmtyh	My mom thinks you're hot
m8t's	friends
m8t	mate
mrau	message received and understood
m8s	mates
mabe	Maybe
mflfs	married female looking for sex
m/b	maybe
mbhsm	My Boobs Hurt So Much
m/f	male or female
m$	Microsoft
mngr	manager
musiq	music
msv	Microsoft Vista
mudda	mother
mssg	message
msm	main stream media
misc.	miscellaneous
moro	tomorrow
m3	me
m2	me too
mmo	Massive Multiplayer Online
msf	male seeking female
myaly	miss you and love you
mpgis	most popular girl in school
m9	mine
m8	friend
mirl	meet in real life
musm	Miss You So Much
mwsmirl	maybe we should meet in real life
mf2f4sx	meet face to face for sex
msh	Me so horny
mpty	more power to you
msg	message
m$wxp	Microsoft Windows XP
m473z	friends
mcs	My computer sucks
m473s	friends
marvy	marvelous
mlc	mid life crisis
mf	motherf**ker
meeh	me
mle	emily
mtr	matter
morf	male or female
mbf	my best friend
myofb	mind your own f**king business
mk	mmm....ok
mu	miss you
mlp	my little pony
mtl	more than likely
mtc	more to come
mtf	More to Follow
mtg	Meeting
muve	multi-user virtual environment
mpbis	most popular boy in school
motd	message of the day
mpih	my penis is hard
m	am
myn	mine
mohaa	Medal of Honor Allied Assult
myob	mind your own business
mngmt	management
mins	minutes
mml8r	meet me later
min	minute
mia	Missing In Action
mlod	mega laugh out loud of doom
mayb	maybe
meatspace	the real world
mcds	mcdonalds
miself	myself
msmd	monkey see - monkey do
miq	make it quick
mir	mom in room
mcse	Microsoft Certified Systems Engineer
miw	mom is watching
mpaw	my parents are watching
moobs	man boobs
m&d	mom and dad
mmlfs	married man looking for sex
miid	my internet is down
mabby	maybe
mutha	mother
mtfbwy	May the Force be with you
moss	member of same sex
m.o	makeout
mai	my
mah	my
mao	my a** off
msngr	messenger
mobo	motherboard
muzik	music
m.i.a	Missing In Action
mgiwjsdchmw	my girlfriend is watching jeff so don't call her my wife
miltf	Mom I'd like to f**k
myodb	mind your own d**n business
mic	microphone
nyc	New York City
newbie	new player
n00dz	nudes
no pro	no problem
nws	not work safe
nowin	knowing
noty	no thank you
nwy	no way
nao	Not As Often
nwrus	no way are your serious 
nsfw	not safe for work
nld	nice lay down
nsfu	no sex for you
nowai	No way
no1	no one
nwj	No Way Jose
nifoc	naked in front of computer
nefing	anything
nr4u	not right for you
ngl	Not Gonna Lie
ntmk	Not to my knowledge
nookie	sex
ntstt	not safe to talk 
nmbr	number
ntmu	nice to meet you
n2mhbu	not too much how about you?
nmhm	nothing much here, man
n2mhjc	not too much here just chillin
nmjc	not much, just chillin'
nmjb	nothing much just bored
nyp	not your problem
nekkid	naked
ntxt	no text
noe	know
nething	anything
nhatm	not here at the moment
nade	grenade
noc	naked on camera
nedn	any day now
nigysob	now I've got you son of a b***h
nmu	nothing much, you
nmjch	Nothing Much Just Chilling
n e	any
nnfaa	no need for an apology
nafkam	Not Away From Keyboard Any More
noaa	National Oceanic and Atmospheric Administration
nop	normal operating procedure
nk	no kidding
nff	not f**king fair
nfd	no f**king deal
nfc	no f**king clue
namh	not at my house
nt	nice try
nfi	no f**king idea
nq	Thank you
nfw	no f**king way
nft	no further text
nfs	not for sale
nfr	not for real
nimby	not in my backyard
nmhwby	nothing much here what about you
nemore	Anymore
np4np	naked pic for naked pic
nntst	no need to say thanks
n/m	nevermind
n/n	nickname
n/o	no offense
nuttin	nothing
nwb	a new person
nevr	never
nn2r	no need to respond
nizzle	n****r
n/a	not applicable
nm u	not much, you
n/c	no comment
njp	nice job partner
neva	never
nthg	nothing
ntk	Need to know
nevm	never mind
npi	no pun intended
nba	national basketball association 
nvrmnd	never mind 
nthn	nothing
nbf	never been f**ked
n00bs	newbies
nbd	no big deal
noob	someone who is new
nei	Not enough information
nbdy	nobody
nmwh	no matter what happens
nwtf	now what the f**k
npe	nope
nite	night
nes	Nintendo Entertainment System
nntr	no need to reply
nty	no thank you
nmw	no matter what
n64	Nintendo 64
naft	Not A f**king Thing
nmp	Not My Problem
norwich	knickers off ready when I come home
newb	someone who is new
npa	not paying attention
nts	note to self
ntt	need to talk
ntw	not to worry
nmf	not my fault
naww	no
nawt	not
n8v	native
ntm	not to much
ntkb	need to know basis
ntn	nothing
ntb	not to bad
nmh	not much here
nstaafl	No Such Thing As a Free Lunch
ntbn	no text-back needed
noyb	none of your business
ndn	indian
ncaa	National Collegiate Athletic Association
nafc	Not Appropriate for Children
nifok	naked in front of keyboard
nyf	not your fault
nme	enemy
nst	no school today
nofi	No Flame Intended
ntmy	nice to meet you
nds	Nintendo DS
n00b	newbie
nsfmf	not so fast my friend
ne1	anyone
noygdb	none of your god d**n business
nb,p	nothing bad, parents
nsa	No Strings Attached
nuffin	nothing
nvr	never
nr	 no reserve
njoy	enjoy
n1994	african american
nufin	nothing
nmjfa	nothing much, just f**king around
ndit	No details in thread
nss	no s**t sherlock
naw-t	Naughty
noes	no
nvmd	nevermind
nttawwt	Not that there is anything wrong with that
nttiawwt	Not that there is anything wrong with that.
npnt	no picture, no talk
nomw	not on my watch
neways	anyways
nmhau	nothing much how about you
nvmt	nevermind that
nvmdt	never mind then
nayl	in a while
ntrly	Not Really
notin	nothing
natm	not at the minute
ntigaf	not that i give a f**k
ncs	no crap sherlock
nrg	energy
nmfp	not my f**king problem
nmjdhw	nothing much just doing homework
nfbsk	not for british school kids
nkt	never knew that
noobz0r	newbie
ntta	nothing to talk about 
newez	anyways
nvrm	Nevermind
n2br	not to be rude
nu	new
nafta	North American Free Trade Agreement
na4w	not appropriate for work
n	and
nub	inexperienced person
noodz	nude pictures
n199312	african american
n2bb	nice to be back
nawidt	never again will i do that
newayz	anyways
nnaa	no not at all
nvm	never mind
n2n	need to know
n2m	not too much
nv	envy
nethin	anything
n2b	not too bad
n2g	Not too good
noobie	new person
n00s	news
ngaf	nobody gives a f**k
n/t	no text
ntty	nice talking to you
n2p	need to pee
nnr	no not really
nrn	No Response Necessary
nh	nice hand
ni	no idea
nj	Nice job
n2mh	not too much here
nm	not much
nmhu	nothing much here, you?
na	not applicable
nah	no
nc	not cool
nd	and
ne	any
nf	not funny
ng	nice game
n/a/s/l	name, age, sex location
nuff	enough
naw	no
nwih	no way in hell
np	no problem
newais	Anyways
nevarz	never
ns	nice
nips	nipples
nmjcu	nothing much, just chilling, you?
n2mu	not too much, you?
nw	no way
nooblet	new player
nmnhnlm	no money, no honey, nobody loves me
nin	no its not
nph	no problem here
nevar	Never
nib	new in box
nic	Network Interface Card
nywy	anyway
nif	non internet friend
npc	Non-playable character
naa	not at all
npgf	no problem girl friend
natch	naturally
nip	nothing in particular
nevah	never
nps	No Problems
nolm	No one loves me
nxt	next
nn	good night
neway	anyway
noub	none of your business
nsas	No Strings Attached Sex
ni994	n***a
ny1	Anyone
nutin	nothing
neday	any day
nthin	nothing
mmorpg	massively multiplayer online role playing game
n1	nice one
n2	into
neida	any idea
nb	not bad
osy	oh screw you
omgihv2p	oh my god i have to pee
ootb	out of the blue
otp	on the phone
ownzer	one who makes others look bad
ootd	outfit of the day
omgih	Oh My God In Heaven
o/y	oh yeah
osd	On Screen Display
olpc	One Laptop Per Child
ohnoez	Oh no
oaw	on a website
otflmao	On the floor laughing my a** off
omwh	on my way home
occ	Occupation
ocd	obsessive compulsive disorder
oday	software illegally obtained before it was released
omfgn	Oh my f**king god noob
omhg	oh my hell god
orlsx	oral sex
oyid	oh yes i did
odtaa	one d**n thing after another
outa	out of
omgny	oh my god no way
ott	over the top
oftpc	off topic
oiyd	Only In Your Dreams
ohic	oh I see
omgg	Oh my gosh girl
omgf	oh my god...f**k!
omgosh	Oh my gosh
omgyg2bk	oh my god you got to be kidding
omgn	oh my goodness
omgz	oh my God
omgwtfhax	Oh My God What The f**k, Hacks!
oll	online love
ommfg	oh my mother f**king god
omgwtfbbq	oh my God, what the f**k
odg	oh dear God
otoh	on the other hand
oobl	out of breath laughing
o rly	oh really
osifgt	oh s**t i forgot
oicic	oh i see i see
o&o	over and out
oh noes	oh s**t!
omgwtfit	Oh my God, what the f**k is that
oh noez	Oh no!
otc	off the chain
otfcu	on the floor cracking up
oways	oh wow are you serious
omgd	Oh my gosh dude
oomf	One of my followers
omg	oh my God
oomm	out of my mind
omj	oh my jesus
oibmpc	oops I broke my computer
omgukk	oh my god you killed kenny
orly	oh really?
oftc	out for the count
omw	on my way
omt	one more time
omy	oh my!
omgsh	oh my gosh
obo	or best offer
obl	osama bin laden
ok	okay
oj	orange juice
og	original gangster
oe	or else
od	over dose
onoz	oh no
o	Oh
oicwydt	oh, i see what you did there
obv	obviously
ot	off topic
os	operating system
op	operator
omgicfbi	Oh my god I can't f**king believe it
ofwg	old fat white guys
oohm	out of his/her mind
omgzors	oh my god
omgykkyb	oh my god you killed kenny you b*****ds
owned	made to look bad
otflmfao	On the floor laughing my f**king a** off
omgroflmao	oh my god roll on the floor laughing my a** off
owt	Out
oww	Oops, wrong window
onoez	oh no
omgty	Oh my god thank you
of10	often
ownzorz	Owned.
omdg	oh my dear god
omdz	Oh My Days 
onud	oh no you didn't
oed	oxford english dictionary
oti	on the internet
otl	out to lunch
ooc	out of character
o.p.	Original Poster
oom	Out of mana
ogw	oh guess what
omfsm	Oh My Flying Spaghetti Monster
otfl	on the floor laughing
onyd	oh no you didn't
oow	On our way
otfp	on the f**king phone
otft	over the f**king top
obtw	oh, by the way
obj	Object
ots	over the shoulder
oicu	oh, i see you!
otw	on the way
omg's	oh my god's
osbutctt	only sad b*****ds use this crappy text talk
omginbd	Oh my God, It's no big deal
ownt	made to look bad
ofcol	oh for crying out loud
orgy	orgasm
oftn	often
omgwtfnipples	on my God, what the f**k
ownz	owns
otflol	on the floor laughing out loud
ohn	oh hell no
ohy	oh hell yeah
omgwtf	on my God, what the f**k
oaoa	over and over again
oink	Oh I Never Knew
oob	out of buisness
oyr	Oh Yeah Right
oyo	on your own
omfwtg	Oh My f**k What The God?
omfg	oh my f**king god
omfd	oh my f**king days
ooym	out of your mind
oar	on a roll
oidia	oops i did it again
omfl	oh my f**king internet connection is slow
omfj	oh my f**king jesus
ooo	out of the office
obgjfioyo	old but good job finding it on your own
orpg	online role playing game
oic	oh, I see
oyfe	Open Your f**king Eyes
ova	over
ocgg	Oh Crap, gotta go
obvi	obviously
oslt	or something like that
omwts	on my way to school
ofc	of course
ojsu	Oh, just shut up!
omfgsh	Oh My f**king Gosh
ofn	Old f**king News
poets	piss off early, tomorrow's Saturday
pto	Personal Time Off 
ptl	Praise the Lord
pbjt	peanut butter jelly time
prolly	Probably
prsn	person
popo	police
prfct	perfect
pwn	made to look bad
psbms	parent standing by my side
probz	probably
pbcakb	problem between chair and keyboard
ps2	Play Station 2
ps3	Play Station 3
ps1	Play Station 1
psp	playstation portable
pachs	parents are coming home soon
pt33n	preteen
proxie	proxy
psos	parent standing over sholder
pron	porn
peanus	penis
puh-leaze	Please
ploxxorz	please
pco	please come over
pcm	please call me
pimfa	pain in my f**king a**
pebcak	Problem Exists Between Chair and Keyboard
po po	police
phail	fail
psa	Public Service Announcement
p00p	poop
p/w	password
pag	Parents Are Gone
phayl	fail
ppls	people
ptw	play to win 
ppppppp	Prior Proper Planning Prevents Piss Poor Performance
ph34r	fear
pnhlgd	parents not home, let's get dirty
pplz	people
ppl	people
pst	please send tell
pbp	Please Be Patient
pcbd	page cannot be displayed
pnbf	Potential new boy friend
peeps	people
pol	parent over looking
prob	problem
plzthx	please? Thanks
plse	please
pbb	parent behind back
pbm	parent behind me
pkemon	pokemon
pleez	please
pcent	percent
pvp	player versus player
pthc	preteen hardcore
pmp	pissing my pants
pvt	pervert
pleaz	please
ploms	parent looking over my shoulder
pl8	plate
plywm	play with me
pmg	oh my God
pml	pissing myself laughing
pmo	pissing me off
prv	private
pwor	power
pr0n	porn
pwnt	owned
pex	Please explain?
pasii	put a sock in it
prollz	probably
pebmac	Problem Exist Between monitor and chair
pob	parent over back
phux	f**k
plma	please leave me alone 
p0wn	make to look bad
piitb	put it in the butt
peep dis	check out what I'm telling you
prvrt	pervert
phuk	f**k
prod	product
phun	fun
plocks	please
pls	please
pyt	pretty young thing
ple's	please
pima	Pain in my a**
parnts	parents
plz	please
plx	please/thanks
pbkc	Problem between keyboard & chair
plars	party like a rock star
promos	promotions
plomb	parents looking over my back
poc	Piece of crap
p2p	peer to peer
pzled	puzzled
p^s	parent over shoulder
pxr	punk rocker
pmsl	piss my self laughing
pwob	Parent watching over back
pmfsl	piss my f**king self laughing
pitr	parent in the room
poscs	parents over sholder change subject
pdq	pretty d**n quick
pics	pictures
pl0x	please
pz	peace
pydim	put your d**k in me
ptfo	passed the f**k out
pdg	pretty d**n good
pwos	parent was over sholder
pbj	peanut butter and jelly
pda	public display of affection
patd	Panic At The Disco
pwn3d	owned
pov	point of view
pow	prisoner of war
pleeze	please
pos	Parent Over Shoulder
pwnz	owns
poq	Piss Off Quick
p-nis	penis
ph33r	fear
phuxor	f**k
prnoscrn	porn on screen
poi	point of interest
p3n0r	penis
p3n15	penis
pnus	penis
pwoms	parent watching over my shoulder
pp	pee pee
pw	parent watching
plos	Parents Looking Over Shoulder
poed	pissed off
pots	Plain Old Telephone Service
plox	please
pihb	pee in his/her butt
pb	peanut butter
platcs	parent looking at the computer screen
pf	profile 
perv	pervert
phreaker	phone hacker
plom	parents looking over me
pk	player kill
pirlos	parent in room looking over shoulder
potc	pirates of the caribbean
pmpl	piss my pants laughing
pl	parent looking
pg	page
pfa	Please Find Attached
pearoast	repost
prn	porn
p@w	parents are watching
pcrs	Parents can read slang
pwnage	Ownage
poms	parent over my shoulder
pker	player killer
prty	party
pfm	Please forgive me
phreak	freak
pfo	please f**k off
pfos	parental figure over sholder
pwn3r	owner
pwd	password
pwb	p***y whipped b***h
pmsfl	Pissed Myself f**king Laughing
pfy	pimply faced youth
p3n1s	penis
pwned	made to look bad
phlr	peace hugs love respect
pww	parents were watching
p4p	pic for pic
prego	Pregnant
pking	player killing
pr0nz	porn
p33n	penis
pmfji	Pardon me for jumping in
p.o.s.	parent over shoulder
p911	parent emergency (parent near)
poo	poop
pmita	pound me in the a**
po	piss off
phuck	f**k
piccies	Pictures
pwnd	owned
pyfco	put your freaking clothes on
pmitap	pound me in the a** prison
piab	panties in a bunch
pce	peace
pach	parents are coming home
pr0	professional
prp	please reply
plams	parents looking at my screen
prd	period
puter	Computer
preggers	pregnant
ph#	phone number
pimha	Pain in my hairy a**
pic	picture
pewp	poop
pro	professional
pix	pictures
plzkthx	Please? OK, Thank you
prw	parents are watching
pbly	probably
po'd	pissed off
pen15	penis
p/oed	pissed off
psn	playstation netwok
pir	parents in room
p.o.b.	Parent Over Back
poontang	female genitalia
pen0r	Penis
piw	Parent is watching
pas	parent at side
pino	Filipino
phear	fear
paw	parents are watching
pliz	please
probly	probably
posmbri	parent over shoulder might be reading it
piihb	put it in her butt
prncss	princess
pae	Pimpin aint easy
peoples	people
pah	parents at home
pebkac	problem exists between keyboard and chair
pns	penis
purty	pretty
penor	penis
p.o.s	parent over shoulder
phm	please help me
prblm	Problem
ptbb	pa** the barf bag
pimpl	pissing in my pants laughing
pita	pain in the a**
pitfa	Pain In The f**king a**
plac	parent looking at computer
plmk	please let me know
phq	f**k you
poidnh	Pics or it did not happen 
pooter	Computer
phucker	f**ker
pleze	please
pwcb	parents watching close by
prncpl	principal
ppor	post proof or recant
phat	pretty hot and tasty
pezzas	parents
pitrtul	parents in the room text you later
pssy	p***y
pb&j	peanut butter and jelly
phag	f**
pwner	owner
pwnzor	owner
qed	I've made my Point
ql	cool
qte	cutie
qpr	quite pathetic really
qft&gj	quoted for truth and great justice
qtpi	cutie pie
qpwd	quit posting while drunk
qt3.14	cutie pie
qq	crying eyes
q4u	question for you
qoolz	cool
q33r	Queer
qna	question and answer
q2c	quick to c**
qfe	quoted for emphasis
qotd	quote of the day
qfmft	quoted for motherf**king truth
qt	cutie
qft	quoted for truth
qotsa	queens of the stone age
qltm	quietly laughing to myself
qool	cool
qoty	quote of the year
roi	Return On Investment
roj	affirmative
rtf	return the favor
rol	rolling over laugihng
roflwtime	Rolling on the Floor laughing with tears in my eyes
rtl	report the loss
rofflecopters	rolling on the floor with laughter
roflmho	Rolling on the floor laughing my head off
r.i.p.	rest in peace
rpita	royal pain in the a**
rox	rocks
rotfl	rolling on the floor laughing
rotflmfaopimp	rolling on the floor laughing my f**king a** off peeing in my pants
rts	Real-time strategy
rofwl	Rolling on the floor while laughing
rta	read the article
ror	raughing out roud
rukm	are you kidding me
rofflecake	rolling on the floor laughing
rotflmao	rolling on the floor laughing my a** off
rgr	roger
rtm	read the manual
ricl	rolling in chair laughing
rowyco	rock out with your c**k out
roflcopter	Rolling on the floor laughing
r8p	rape
rufkm	are you f**king kidding me
rihad	Rot In Hell And Die
r8t	rate
rehi	hello again
roflmfaopimp	rolling on the floor laughing my f**king a** off pissing in my pants
rwb	Rich White b***h
roflmaoapimp	rolling on the floor laughing my a** off and peeing in my pants
rbty	right back to you
rplbk	reply back
rotglmao	rolling on the ground laughing my a** off
roflmaool	Rolling on the floor laughing my a** off out loud
roofles	rolling on the floor laughing
rbtl	Read between the lines
roflmaowpimp	rolling on floor laughing my a** off while peeing in my pants
rofpml	rolling on the floor pissing myself laughing
roflmgdao	rolling on the floor laughing my god d**n a** off
roflmaouts	Rolling on floor laughing my f**king a** off unable to speak
rotfflmao	rolling on the f**king floor laughing my a** off
rn	Right now
rnt	aren't
roflmgo	Rolling On Floor Laughing My Guts Out
ruabog	are you a boy or girl
rlly	really
rtfa	read the f**king article
rtfm	read the f**king manual
ritjive	non virgin
rmso	Rock My socks off
rockr	rocker
roxxor	rock
rtfu	Ready the f**k up
rolmao	Rolling Over Laughing My a** Off
ruwm	are you watching me
roger	affirmative
retrotextual	One who is using out of date words and abbreviations while texting.
rtfs	read the f**king summary
ruh	are you horny
roglmfao	rolling on ground laughing my f**king a** off
rbay	right back at you
rotg	rolling on the ground
rotf	rolling on the floor
rmr	remember
rtfp	read the f**king post
rotflmbo	rolling on the floor laughing my butt off
rents	parents
ruk	are you ok?
rtfmfm	read the f**king manual f**king moron
rotfwlmao	rolling on the floor while laughing my a** off
rtr	Read the Rules
rentz	parents
reefer	marijuana
rotflol	rolling on the floor laughing out loud
rotfalol	roll on the floor and laugh out loud
rme	rolling my eyes
rtfq	Read The f**king Question
ru	are you
rp	roleplay
roflmiaha	Rolling on the floor laughing myself into a heart attack
rr	rest room
rep	to represent
re/rehi	hello again
rotffl	roll on the f**king floor laughing
re	reply
rtard	retard
rl	real life
rm	room
rite	right
ro	rock out
r-tard	retard
rff	really f**king funny
ruagoab	are you a girl or a boy
rotfflmfao	rolling on the f**king floor laughing my f**king a** off
rln	real life name
rtffp	Read the f**king front page
rlg	really loud giggle
rlf	Real Life Friend
rotflmaofaktd	Rolling on the floor laughing my a** off farted and killed the dog
rly	really
rlz	rules
rur	are you ready
rotw	rest of the world
rut	are you there
rcsa	right click save as
roflmao	rolling on the floor laughing my a** off
roflao	rolling on the floor laughing my a** off
rcks	Rocks
rdy	ready
rfn	right f**king now
rtfms	Read The f**king Manual Stupid
rotflmfaopmp	rolling on the floor laughing my a** off pissin my pants
rlgf	Real Life Girl Friend
roflmfaopmp	rolling on flor laughing my f**king a** of peeing my pants
rofc	Rolling On Floor Crying
rlbf	Real Life Boy Friend
ryte	right
roffles	rolling on floor laughing
rotflmfao	rolling on the floor laughing my f**king a** off
rofl	rolling on the floor laughing
rino	republican in name only
rofalol	roll on the floor and laugh out loud
rumf	Are you male or female
rpg	role playing game
rlze	realize
rpo	royally pissed off
roflmgdmfao	roling on floor laughing my god d**n mother f**king a** off
rawks	rocks
rotflmaostc	rolling on the floor laughing my a** off scaring the cat
roffle out loud	rolling on the floor laughing out loud
rong	wrong
roflpmp	rolling on the floor laughing peeing my pants
roffle	rolling on the floor laughing
reppin	representing
rotflmho	rolling on the floor laughing my head off
rolmfao	rolling over laughing my f**king a** off
rugay	are you gay
rele	really
roxor	rock
rawr	roar
rtry	retry
rsn	real soon now
rodger	affirmative
raoflmao	rolling around on floor laughing my a** off
rogl	rolling on ground laughing
rrb	restroom break
roids	steroids
roflpimp	rolling on the floor laughing pissing in my pants
r0x0rz	rocks
rflmao	rolling on the floor laughing my a** off
rawk	Rock
rsp	respawn
rotflmaool	rolling on the floor laughing my a** off out loud
roflmgao	rolling on the floor laughing my gay a** off
roffleol	rolling on the floor laughing out loud
rb@u	right back at you
rotfpm	rolling on the floor pissing myself
roflastc	Rolling On Floor Laughing And Scaring The Cat
rbm	right behind me
r	are
rugta	are you going to answer
rotflmfho	rolling on the floor laughing my f**king head off
rtbq	Read The Blinking Question
roflkmd	rolling on the floor laughing kicking my dog
roflolbag	Rolling On The Floor Laughing Out Loud Busting A Gut
r8pist	rapist
rua	are you alone
rotgl	roll on the ground laughing
rofllh	rolling on the floor laughing like hell
refl	rolling on the floor laughing
rtfmm	read the f**king manual moron
rotflmmfao	rolling on the floor laughing my mother f**king a** off
rsps	Runescape Private Server
rotflaviab	rolling on the floor laughing and vomiting in a bucket
rjct	reject
roflol	rolling on floor laughing out loud
rombl	rolled off my bed laughing
ryt	right
ruok	are you ok?
rhcp	red hot chilli peppers
r8	rate
rbau	right back at you
r2f	Ready To f**k
rhs	right hand side
roflcopters	rolling on the floor laughing, VERY funny.
rhgir	really hot guy in room
roflmbfao	Rolling On Floor Laughing My Big Fat a** Off 
ra2	red alert 2 (game)
ra3	Red Alert 3 (game)
rcvd	received
rq	real quick
rtg	ready to go
roflmmfao	rolling on the floor laughing my mother f**king a** off
rubz2nt	are you busy tonight
rspct	respect
roflmbo	rolling on floor laughing my butt off
roxorz	rocks
roflmaopmp	rolling on the floor, laughing my a** off, pissing my pants
ru18	are you 18
rifk	rolling on the floor laughing
rofl&pmp	rolling on floor laughing and peeing my pants
rofflmfao	rolling on the floor laughing my f**king a**
s'pose	suppose
smeg	f**k
shiat	s**t
steamloller	Laughing. Alot.
shure	sure
sl4n	so long for now
swak	sealed with a kiss
sexilicious	Very Sexy
sdlc	Software Development Life Cycle
sumfin	Something
swafk	sealed with a friendly kiss
skillz	skills
sk8r	skater
stfu	shut the f**k up
scnr	sorry, I couldn't resist
slore	s**tty w***e
snafu	situation normal all f**ked up
ssia	subject says it all
sbt	sorry bout that
suxor	Sucks
sul	see you later
suk	suck
sprm	sperm
sut	see you tomorrow
sus	see you soon
sup	what's up
sux	sucks
sexc	sexy
sexe	sexy
sexi	Sexy
smho	Screaming My Head Off
suxorz	sucks
s.o.a.b.	son of a b***h
suxors	sucks
slf	sexy little f**k
skool	school
slos	someone looking over shoulder
shiznit	s**t
sofas	stepping out for a smoke
stfng	search the f**king news group
sgi	Still got it
sgb	straight/gay/bisexual
sk8ter	skater
shyat	s**t
shite	s**t
soobs	saggy boobs
sumthin'	Something
suxx	sucks
srch	search
sorg	Straight or Gay
s.i.n.g.l.e	Stay intoxicated nightly, get laid everyday.
sytycd	so you think you can dance 
smto	Sticking My Tongue Out
syrs	see ya real soon
stfuppercut	shut the f**k up
smtm	sometime
spk	speak
sis	sister
str8	straight
siu	suck it up
swmbo	she who must be obeyed
sic	said in context
sig	Signature
sif	as if
sk8er	skater
smst	somebody missed snack time
snf	so not fair
stfugbtw	shut the f**k up and get back to work
sydim	stick your d**k in me
snl	Saturday Night Live
snm	say no more
s'ok	it's okay
sz	sorry
sx	sex
ssl	secure sockets layer
ss	screenshot
sw	so what
scool	school
su	shut up
st	Stop That
sk	spawn kill
sh	s**t happens
sn	screen name
sm	social media
stfun	Shut the f**k up n****r
sg	so good
sd	suck d**k
sqtm	snickering quietly to myself
see through your eyes	stye
sool	s**t out of luck
spos	stupid peace of s**t
sk8ing	Skating
sssd	Same s**t Same Day
srsly	seriously
sl^t	s**t 
srly	seriously
smexy	sexy
sfsg	So far so good
shmexy	sexy
siol	Shout It Out Loud
skhool	school
sitmf	say it to my face
smthin	something
smt	suck my tits
suyah	shut up you a** hole!
som'm	something
smh	shaking my head
smf	stupid motherf**ker
smd	suck my d**k
smc	suck my c**k
smb	see my blog
sbs	such bull s**t
sgtm	slightly gigling to myself
shup	shut up
shizit	s**t
smfd	suck my f**king d**k
sbc	sorry bout caps
shud	should
sbd	silent but deadly
sumtin	something
syotbf	see you on the battlefield
siuya	 shove it up your a**
sahm	stay at home mom
sm1	someone
ss4l	smoking sista for life
sfam	Sister from another mother
shmily	see how much i love you
s3x	Sex.
sho'nuff	sure enough
sosg	spouse over shoulder gone
sux0rz	sucks
sroucks	that's cool, but it still sucks
sbcg4ap	strongbads cool game for attractive people
skoul	school
st1	stoned
siao	school is almost over
st8	state
syoa	Save Your Own a**
ssob	stupid sons of b***hes
swtf	seriously, what the f**k
shld	should
std	sexually transmitted disease
stg	swear to god
stb	soon to be
stm	smiling to myself
sth	something
stt	Same time tomorrow
stw	share the wealth 
sts	so to speak
sah	sexy as hell
sab	slap a b***h
shtf	s**t hits the fan
s.i.t.	stay in touch
suka	Sucker
soad	system of a down
soab	son of a btch
sukz	sucks
snog	kiss
shizz	s**t
sfy	speak for yourself
sfw	safe for work
smbt	Suck my big toe
sfu	shut the f**k up
sfr	so f**king random
sk8tr	skater
shyt	s**t
smtoay	Sticking my tongue out at you
sfh	So f**king Hot
smbd	suck my big d**k 
sfe	safe
seks	sex
s4se	Sight For Sore Eyes
simcl	sitting in my chair laughing
stff	stuff
stfd	sit the f**k down
sagn	Spelling and Grammar Nazi
syiab	see you in a bit
stfm	search the f**king manual
syiaf	see you in a few
stfw	search the f**king web
sowi	sorry
suxxor	sucks
sexx0rz	sex
somadn	sitting on my a** doing nothing
scrilla	money
slgb	Straight/Lesbian/Gay/Bisexual
silf	Sister I'd Like To f**k
s'up	what is up
stufu	stupid f**ker
syl8r	see you later
sht	s**t
serp	search engine results page
sdf^	shut da f**k up
shd	should
sthu	shut the hell up
suagooml	shut up and get out of my life
sho	sure
simclmao	sitting in my chair laughing my a** off
sez	says
seg	s**t Eatin Grin
sed	said
sec	second
s8ter	skater
seo	Search Engine Optimization
swakaah	Sealed With A Kiss And A Hug
sleepin	sleeping
sorta	sort of
soafb	son of a f**king b***h
sista	Sister
skwl	school
stfuogtfo	Shut the f**k up or get the f**k out.
smfpos	stupid mother f**king piece of s**t
sifn't	as if not
stby	sucks to be you
stupd	stupid
swm	single white male
sploits	exploits
sgbadq	Search google before asking dumb questions
sploitz	exploits
swf	single white female
snew	what's new
snes	Super Nintendo Entertainment System
sked	schedule
secks	sex
swt	sweet
stoopid	stupid
suabq	shut up and be quiet
sutuct	so you think you can type
sosdd	same old s**t, different day
slt	something like that
slp	sleep
slo	slow
sobs	same, old, boring s**t
smhb	suck my hairy balls
shut^	shut Up
sitb	sex in the but
stys	speak to you soon
stfuyb	shut the f**k up you b***h
smofo	stupid mother f**ker
s2a	sent to all
stfub	shut the f**k up b***h
stfua	shut the f**k up already
sellin	selling
swalk	sealed with a loving kiss
some1	someone
s2r	send to receive
shag	f**k
s2u	same to you
shawty	girl
sfwuz	safe for work until zoomed
srvis	Service
sym	shut your mouth
syl	see you later
sys	see you soon
syu	sex you up
syt	see you there
shizzle	s**t
sydlm	Shut your dirty little mouth
sum1	someone
stfuda	Shut the f**k up dumb a**
sleepn	sleeping
shexi	sexy
shexy	sexy
str8up	straight up
skl	School
stpd	stupid
secksea	Sexy
smdb	suck my d**k b***h
sokay	it's okay
shwr	shower
srynd2g	sorry need to go
shuddup	Shut Up
sowwy	sorry
s2us	Speak to you soon
sfipmp	so funny I peed my pants
stbx	soon to be ex
siggy	Signature
smthng	something
soml	story of my life
sk8	skate
sktr	skater
s.w.a.k.	sealed with a kiss
sux2bu	sucks to be you
stfuysoab	shut the f**k up you son of a b***h
srzly	seriously
sotr	sex on the road
syfm	shut your f**king mouth
s/b	should be
skeet	ejaculate
sblai	stop babbaling like an idiot
sfs	so f**king stupid
smithwaws	Smack me in the head with a wooden spoon
som1	someone
sofs	same old f**king s**t
smdvq	suck my d**k quickly
slng	slang
srs	serious
sfm	so f**king much
shiznat	s**t
sysop	system operator
sry	sorry
sxcy	sexy
soa	service oriented architecture 
soc	Same old crap
sob	son of a b***h
soe	service oriented enterprise
sof	smile on face
soi	service oriented infrastructure
shrn	so hot right now
sok	It's ok
sol	s**t outta luck
soo	So
shiet	s**t
sop	same old place
sos	same old s**t
sot	suck on this
soz	sorry
suib	shut up im busy
scrt	secret
sthing	something
stsp	Same Time Same Place
susfu	situation unchanged, still f**ked up
swmt	Stop Wasting My Time 
sorreh	sorry
sumone	someone
swsw2b	single when she wants to be
swp	sorry wrong person
supposably	Supposedly
sdk	Software Development Kit
snogged	kissed
skewl	school
sbrd	so bored
ssry	so sorry
supa	super
s.o.b.	son of a b***h
snafubar	Situation Normal All f**ked Up Beyond Any Recognition
sxc	sexy
sxe	straight edge
showin	showing
sxi	sexy
shiz	s**t
sxs	sex
secksy	sexy
sxy	sexy
sicl	sitting in chair laughing
scurred	scared
stfuah	shut the f**k up a**h**e
sibir	sibling in room
sexii	sexy
*s*	smile
syatp	see you at the party
s2bu	Sucks to be you
sotc	stupid off topic crap
svn	seven
srry	sorry
summin	something
ssdd	same s**t, different day
sase	self addressed stamped envelope
ssdp	same s**t different pile
svu	special victims unit
totes	totally
tx	thanks
ty	thank you
ttyo	talk to you online
ttyn	talk to you never
ttyl	talk to you later
tyty	thank you thank you
ts	talking s**t
tp	toilet paper
tq	Thank You
ttyw	talk to you whenever
tl	Tough Luck
ttyt	talk to you tomorrow
ttys	talk to you soon
tk	team kill
taig	That's all I got. 
tyto	take your top off
te	Team effort
tb	text back
tc	take care
ta	thanks again
tpiwwp	this post is worthless without pictures
tl:dr	Too Long; Didn't Read
tfbundy	totaly f**ked but unfortunatly not dead yet
tlk2ul8r	talk to you later
trd	tired
tru	true
teh	the
teotwawki	the end of the world as we know it
ttiuwp	This Thread Is Useless Without Pictures
t2m	talk to me
tgfuap	thank god for unanswered prayers
ttbc	Try to be cool
t2b	time to blunt
twttr	twitter
t2u	talking to you
tiic	the idiots in control
tv	television
tanq	thank you
thatz	that's
tw	Teacher Watching
tu	thank you
toya	thinking of you always
tioli	take it or leave it
txt	text
txs	thanks
twf	That was funny
twg	That was great
tmmrw	tomorrow
twi	Texting While Intoxicated
typo	typing mistake
twvsoy	that was very stupid of you
thru	through
tysfm	thank you so f**king much
tmrrw	tomorrow
tisly	that is so last year
ttth	Talk To The Hand
tswc	tell someone who cares
tyclos	turn your CAPS LOCK off, stupid
tttt	to tell the truth
tg	thank god
tok2ul8r	i'll talk to you later
trani	transexual
tbss	too bad so sad
tnx	thanks
tnf	That's Not Funny
tna	tits and a**
thr4	therefore
tat	that
tau	thinking about you
taw	Teachers are Watching
tbnt	thanks but no thanks
tay	thinking about you
tt4n	ta ta for now
tmsidk	tell me somthing I don't know
ttfaf	Through the Fire and Flames
tal	thanks a lot
tai	think about it
ttfn	ta ta for now
txtyl	text you later
tilf	Teenager I'd Like To f**k
twyl	Talk With You Later
taci	that's a crappy idea
twys	Talk With You Soon
tmtmo	text me tomorrow
tlkin	talking
tfic	Tongue Firmly In Cheek
ttyiam	talk to you in a minute
ttiuwop	this thread is useless without pics
tdwdtg	The Devil Went Down To Georgia
tty	Talk to You
tts	text to speech
ttr	time to run
ttt	to the top
ttm	talk to me
ttl	total
ttc	text the cell
ttylo	talk to you later on
thnx	thanks
tsc	that's so cool
thanx	thank you
thnk	think
ttylt	talk to you later today
tss	That's so sweet
tmbi	tell me about it
thanq	thank you
tjb	thats just boring
twbc	that would be cool
tthb	try to hurry back
ttus	talk to you soon
tisc	that is so cool
tisg	this is so gay
terd	s**t
tiss	This is some s**t
ttyitm	talk to you in the morning
tisw	that is so wrong
tlyk	to let you know
tranny	Transexual
tafn	That's all for now
troll	person who diliberately stirs up trouble
tws2wa	That was so 2 weeks ago
tmaai	tell me all about it
tcoy	take care of yourself
tias	Try It And See
tlgo	The list goes on
thxx	thanks
t,ftfy	there, fixed that for you
tiai	take it all in
tyfyc	Thank You For Your Comment
taht	that
tanstaafl	there ain't no such thing as a free lunch
thwy	the hell with you!
tysm	thank you so much
tddup	till death do us part
ttul	Talk To You Later
twat	vagina
ttut	Talk to you Tomorrow
tf2	Team Fortress 2
tl; dr	To Long; Didn't read
tos	terms of service
tbph	To be perfectly honest
tou	thinking of you
tok	That's ok
toh	typing one handed
tob	teacher over back
tfm	too f**king much
tfl	Thanks For Looking
tfh	Thread from hell
tfd	total f**king disaster
tmoz	tomorrow
tff	That's f**king Funny
tfa	the f**king article
tfc	Team Fortress Classic
tfb	time for bed
t4m	Transgender for Male
tfu	that's f**ked up
t4a	thanks for asking
tfs	thanks for sharing
tgfe	together forever
twoh	typing with one hand
tgiwjo	Thank God It Was Just Once
tgfu	too good for you
tgft	thank god for that
tat2	tattoo
thwdi	thats how we do it
twdah	that was dumb as hell
ttutt	to tell you the truth
tyvm	Thank You Very Much
tfft	thank f**k for that
tldr	Too long, didn't read.
tffw	Too funny for words
tnxz	thanks
tgtbt	Too Good To Be True
tyl	text you later
tym	time
tarfu	things are really f**ked up
tmtt	tell me the truth
tuvm	thank you very much
tgwig	thank god wife is gone
tisfu	that is so f**ked up
tyt	take your time
tmth	too much to handle
tlkn	talking
typ	thank you partner
tiafayh	Thanks in advance for all your help
tys	Told You So
tldnr	too long, did not read
ttyob	tend to your own business
tpb	the pirate bay
ttiwwop	This thread is worthless without pics
tps	test procedure specification
tdtm	Talk Dirty To Me
ttly	totally
tkd	Tae Kwon Do
ttbomk	to the best o fmy knowledge
ttytm	talk to you tomorrow
tlk2me	talk to me
tku	thank you
ttytt	to tell you the truth
tks	thanks
tyvvm	thank you very very much
tbhimo	to be honest in my opinion
trnsltr	translator
tghig	thank god husband is gone
tbp	The Pirate Bay
tbh	to be honest
tyfyt	Thank you for your time
tba	to be anounced
tbc	To be continued
tbd	to be decided
tbf	to be fair
twss	That's what she said
tstoac	too stupid to own a computer
tbfu	too bad for you
twsy	That was so yeterday
trnsl8	translate
tmwfi	Take my word for it
tker	team killer
tbfh	to be f**king honest
t/a	Try again
ttyab	Talk to you after breakfast
ttyad	Talk to you after Dinner
ttyal	Talk to you after lunch
ttyas	talk to you at school
tfiik	the f**k if i know
t8st	taste
tut	take your time
tuh	to
tfti	thanks for the information
tgws	that goes without saying
tmr@ia	the monkeys are at it again
thot	the hoe of today
tfta	thanks for the add
tfu2baw	time for you to buy a watch
tla	Three Letter Acronym
tld	told
tlk	talk
tmai	tell me about it
ttrf	That's the rules, f**ker
tchbo	Topic creater has been owned
tmnt	teenage mutant ninja turtles
ttms	talking to myself
twis	that's what I said
tmsg	tell me something good
ttml	talk to me later
tinla	this is not legal advice
tcp/ip	transmission control protocol/internet protocol
tgif	thank god it's friday
tl,dr	Too long; didn't read
tinf	this is not fair
tgis	thank god it's saturday
ttiwwp	this thread is worthless without pics
tsnf	that's so not fair
tysvm	thank you so very much
t3h	the
ti2o	that is too obious
tiatwtcc	this is a trap word to catch copiers
ttihlic	try to imagine how little i care
ttlly	totally
tmsaisti	That's my story and I'm sticking to it.
tgsttttptct	thank God someone took the time to put this crap together
tlc	tender loving care
ttyna	talk to you never again
ttynl	talk to you never loser
ttynw	talk to you next week
ttul8r	Talk to you later
tbqf	to be quite frank
tbqh	to be quite honest
thku	thank you
tisnf	that is so not fair
th@	that
thz	thank you
thx	thank you
tht	that
thr	there
tho	though
thn	then
ttywl	Talk to you way later
tha	the
t.t.y.l	Talk To You Later
tcp	transmission control protocol
tcg	Trading Card Game
tard	retard
thankx	thank you
tif2m	this is f**king 2 much
td2m	talk dirty to me
tfln	thanx for last night
thankies	Thank You
tb4u	too bad for you
tmrw	Tomorrow
tmrz	tomorrow
tk2ul	talk to you later
tvm	thanks very much
tliwwv	this link is worthless without video
trble	trouble
twfaf	thats what friends are for
tmr	tomorrow
tms	that makes sense
ttyrs	talk to you really soon
tmw	Too much work
tmz	tomorrow
totm	top of the morning
totl	total
tma	take my advice
totp	talking on the phone
tmi	too much information
tmk	to my knowledge
tml	tell me later
tmo	take me out
txting	texting
tdl	Too d**n Lazy
tdf	To Die For
tolol	thinking of laughing out loud
tn1	trust no-one
tltpr	Too long to proof read.
ttyl8r	talk to you later
tnlnsl	Took nothing left nothing signed log
tomm	tommorow
tyred	tired
thar	there
tofy	Thinking of You
t#3	the
tsig	that site is gay
tifu	that is f**ked up
tifs	this is funny s**t
tsff	thats so f**kin funny
tigger	tiger
tmoro	tomorrow
tcial	The cake is a lie
tgfitw	The Greatest Fans In The World
tbtfh	to be totally freaking honest
tmtoyh	Too Much Time On Your Hands
t2ul8r	talk to you later
tl;dr	too long; didn't read
tgiff	thank god its f**king Friday
tcfc	Too Close For Comfort
tcfm	too cool for me
totpd	top of the page dance
tbvh	to be very honest
tl8r	talk later
t2ul	talk to you later
tix	tickets
ttyotp	talk to you on the phone
tyme	time
tinstaafl	There Is No Such Thing As A Free Lunch
tiw	teacher is watching
tis	is
til	until
tuff	tough
tptb	the powers that be
tif	this is fun
tia	thanks in advance
taunch	te amo un chingo
tbpfh	To be perfectly f**king honest
ttiuwiop	this thread is useless without pics
tomoz	tomorrow
twajs	That was a joke, son.
tyfn	thank you for nothing
tyfi	Thank You for invite
ukwim	you know what i mean
utube	youtube
u'll	you will
u4i	up for it
ur2g	you are too good
uom	You owe me
urms	you rock my socks
ursdf	you are so d**n fine
urmw	you are my world
uwc	you are welcome
uyab	up your a** b***h
utfse	use the f**king search engine
un2bo	you need to back off
upw	unidentified party wound
urtbitw	You are the best in the world!
uayor	Use At Your Own Risk
urssb	you are so sexy baby
udek	you don't even know
urafb	you are a f**king b***h
ufic	Unsolicited Finger in Chili
ufia	unsolicited finger in the anus
uryyfm	you are too wise for me
uve	You've
ursh	you are so hot
u2u	up to you
ufab	ugly fat a** b***h
url8	you are late
ursg	you are so gay
utm	you tell me
ujds	u just did s**t
upcia	unsolicited pool cue in anus
umfriend	sexual partner
ufr	Upon further review
uty	it's up to you
unt	until next time
urtw	you are the worst
uctaodnt	you can't teach an old dog new tricks
uraqt	you are a cutie
ugba	you gay b***h a**
urtb	you are the best
ursab	you are such a b***h
ussr	The Union of Soviet Socialist Republics
ugtr	you got that right
usd	United States Dollar
ukr	You know right
u2	You too
uhems	you hardly ever make sense
u iz a 304	you is a hoe
ur6c	you're sexy
udwk	you don't want to know
uds	you dumb s**t
upmo	You piss me off
udc	you don't care
usck	you suck
urcrzy	you are crazy
uta	up the a**
uvgtbsm	you have got to be shiting me
ut	you there
uw	you're welcome
ur	your
urstpid	you are stupid
ul	unlucky
ui	User Interface
utw	used to work
u've	You've
ua	user agreement
uber	over
utfs	Use the f**king search
urstu	you are stupid
uat	User Acceptance Testing
urnc	you are not cool
uhab	you have a blog
usux	you suck
ufmf	you funny mother f**ker
uaaaa	Universal Association Against Acronym Abuse
upia	unsolicited pencil in anus
usuk	You Suck
uradrk	you're a dork
udy	you done yet
u'd	you would
uya	up your a**
upos	you piece of s**t
u'r	you're
u'v	you have
urtrd	you retard
ure	you are
urg	you are gay
ura	you are a
u/n	username
ulbom	you looked better on myspace
urw	you are weird
u	you
uttm	 you talking to me?
urs	yours
ub3r	super
un4rtun8ly	unfortunately
urht	you're hot
u/l	upload
vb	visual basic
vid	Video
vbeg	very big evil grin
vn	very nice
vweg	very wicked evil grin
vip	very important person
vwd	very well done
vajayjay	vagina
vgl	very good looking
vgn	Video Game Nerd
vgh	Very good hand
vf	very funny
vgg	very good game
vag	vagina
vids	Videos
vnc	Virtual Network Computing
vleo	Very Low Earth Orbit
vry	very
vrsty	Varsity
vnh	Very nice hand
vzit	visit
voip	voice over ip
vzn	verizon
vfm	value for money
vbg	very big grin
vff	Verry f**king Funny
vfe	Virgins 4 ever
vlog	video log
v4g1n4	vagina
wywo	while you were out
wywh	wish you were here
wiid	what if i did
wats^	what's up?
wassup	what's up?
wml	Wish Me Luck
wybts	were you born this sexy
wmd	Weapons Of Ma** Destruction
wthru	Who the heck are you
w00t	woohoo
wsb	wanna cyber?
wtfhwt	what the f**king hell was that
wyatb	wish you all the best
wsf	we should f**k
wau^2	what are you up to?
wthrud	what the hell are you doing?
wmao	working my a** off
waloc	what a load of crap
whaletail	thong
wyhi	Would You Hit It?
witwwyt	what in the world were you thinking
wtfdik	what the f**k do i know
watevs	whatever
watevr	whatever
wrdo	weirdo
w8ter	waiter
watev	whatever
wdf	Worth Dying For
wanafuk	wanna f**k
wadzup	What's up?
wwdhd	What would David Hasselhoff do
whevah	where ever
wif	With
wid	with
waysttm	why are you still talking to me
wio	without
wiw	wife is watching
wiv	with
wiu	What is up?
wit	with
wieu2	What Is Everyone Up To
wip	Work In progress
wuut	what you up to
wu2kilu	want you to know I love you
w/out	without
wthigo	what the hell is going on
wdim	What Did I miss
wrthls	Worthless
wtii	what time is it
wtfrudng	what the f**k are you doing
wyas	wow you are stupid
wdhlm	why doesnt he love me?
wanker	masturbater
whatev	whatever
waysw	Why are you so weird
wuu2	what you up to
watcha	what are you
wcutm	what can you tell me
wduwta	what do you wanna talk about
wauw	what are you wearing
wtfmf	what the f**k mother f**ker
warez	illegally obtained software
wuny	wait until next year
wdywtdt	Why Do You Want To Do That?
wnrn	why not right now
wu	what's up?
w8t4me	wait for me
wwgf	when we gonna f**k
w911	Wife in room
waz ^	what's up
w8ing	waiting
w2f	want to f**k
w2g	Way to go
w2d	what to do
wtva	whatever
whever	whatever
wtvr	whatever
wsidi	Why Should I Do It
wuv	love
wut	what
wuz	was
wfhw	what's for homework
wub	love
wtcf	what the crazy f**k
wud	would
wrd	word
wrm	which reminds me
wrk	work
wtgp	Want to go Private
wrt	with regard to
wru	where are you
wudev	Whatever
wwut	what were you thinking
wwtf	what was that for
wtfaud	what the f**k are you doing?
wsi	why should I
wwikt	why would i know that
wtfwjd	what the f**k would jesus do
wthaydwmgf	what the hell are you doing with my girlfriend
wtmi	way too much information
wtmf	what the mother f**k
whtever	whatever
wbrb	Will be right back
whit	with
wtfbs	What the f**k bull s**t
whaddya	what do you
wgo	what's going on
was^	What's Up
wwjd	what would jesus do?
wmyb	What Makes You Beautiful
wts	want to sell
wam	wait a minute
wltm	would like to meet
wths	want to have sex
wthwut	what the hell were you thinking
wrud	what are you doing
wruf	where are you from
waf	weird as f**k
wlc	welcome
wld	would
wuteva	whatever
wansta	wanna be ganster
wtfdum	what the f**k do you mean
wtfiuwy	what the f**k is up with you
witwct	What is the world coming too
wutevr	what ever
wthyi	what the hell you idiot
wpe	worst president ever (Bush)
widout	without
wtfduw	What the f**k do you want?
w.e.	whatever
winnar	winner
wtfwt	what the f**k was that
wtho	want to hang out?
wubu2	what you been up to
wyw	What You Want
wuwtb	what do you want to talk about
wuwta	what do you want to talk about
w'sup	what's up
wudn	what you doing now
wtwr	well that was random
witcha	with you
w2ho	want to hang out
wasup	What's Up
wtfiu	what the f**k is up
wtfit	what the f**k is that
wubut	what you been up too
wypsu	will you please shut up
wotevs	whatever
wdwgw	where did we go wrong
whut	what
wysiwyg	what you see is what you get
wna	want to
wafn	what a f**ken noob
wafl	what a f**king loser
wtfits	what the f**k is this s**t
wduwtta	what do you want to talk about
wyg	will you go
wuu22m	what you up to tomorrow
wcw	webcam w***e
wthauwf	what the hell are you waiting for
whubu2	what have you been up to
w.b.s.	Write Back Soon
wtfruo	what the f**k are you on?
whteva	what ever
whf	Wanna have fun?
whteve	whatever
werkz	works
wht	What
whtevr	whatever
whr	where
whs	wanna have sex
wruu2	what are you up to
wats	whats
wc3	Warcraft III
wswta	What shall we talk about?
wgph2	Want to go play Halo 2?
wjwd	What Jesus Would Do
wtrud	what are you doing
wduc	what do you care
wutcha	What are you
wtfdyw	what the f**k do you want
wdum	what do  you mean
wotv	What's on Television?
wotw	word of the week
wayut	what are you up to
wduw	what do you want
wdut	what do you think?
wdus	What Did You Say
whenevs	whenever
wtly	Welcome to last year
whats ^	whats up
woot	woohoo
wnkr	wanker
wfyb	whatever floats your boat
weve	what ever
wysitwirl	what you see is totally worthless in real life
walstib	what a long strange trip it's been
wad ^	what's up?
wevr	whatever
woft	Waste of f**king time
w/u	with you
w/end	weekend
wazza	what's up
wysiayg	what you see is all you get
w/o	with out
w/e	whatever
wiuwu	what is up with you
w/b	write back
wygam	When you get a minute
wtp	where's the party
w/	with
wwhw	when where how why
wygac	when you get a chance
whatevs	whatever
wtfuah	what the f**k you a**h**e
wtfrud	What the f**k are you doing?
wtt	want to trade
wylym	Watch Your Language Young Man
w8	wait
woz	was
wkend	weekend
wot	what
wayt	What are you thinking?
wlkd	walked
wayh	why are you here
wayn	Where Are You Now
wgasa	who gives a s**t anyway
woe	what on earth
woa	word of advice
woc	welcome on cam
wayd	what are you doing
wg	wicked gril
wd	well done
wc	who cares
wb	welcome back
wtv	Whatever
wn	when
wl	will
wk	week
wygwm	will you go with me
wdytia	who do you think i am?
wtc	what the crap
wtd	what the deuce
wtf	what the f**k
wp	wrong person
wth	what the heck
whtvr	whatever
wy	Why?
wtbh	What the bloody hell
wiyp	what is your problem
waygow	who are you going out with
wtfwtd	what the f**k was that dude
wtb	Want to buy
webby	webcam
w33d	weed
wateva	whatever 
wuza	what's up
wtfigo	what the f**k is going on
wdym	what do you mean
wtg	way to go
wwyd	what would you do?
wdye	What do you expect
wdys	What did you say
wdyw	what do you want
wdyt	what do you think
wtfhb	what the f**king hell b***h
wafda	What a f**king Dumb a**
wula	what you looking at?
wowzers	wow
wtiiot	What time is it over there?
wubmgf	Will You Be My Girlfriend?
wdwdn	what do we do now
wogge	what on god's green earth?
wthhyb	where the hell have you been?
waycb	when are you coming back
wtfwtf	what the f**k was that for?
watz ^	What's up
wilco	will comply
wntd	what not to do
wfh	Working From Home
wtfay	who the f**k are you
wfm	Works For Me
wana	want to
wtfayta	What the f**k are you talking about?
wtfrudoin	what the f**k are you doing
waug	Where are you going
wiwt	wish i was there 
wafm	wait a f**king minute
wthiwwu	What the hell is wrong with you
wkd	wicked
wwcnd	What would Chuck Norris do
wthwt	what the hell was that?
wsibt	when should i be there
wthayd	what the heck are you doing
w2m	want to meet
wuwtta	what you want to talk about
wuwu	what up with you
wuwt	what's up with that
wlos	wife looking over Shoulder
wanking	Masturbating
wwudtm	what would you do to me
wuwh	Wish you were here
wyltk	wouldn't you like to know
wshtf	when s**t hits the fan
wwwy	what's wrong with you
wtfs	what the f**king s**t?
wycm	Will You Call Me
wtfh	what the f**king hell
wtfo	what the f**k over
wtfm	what the f**k, mate?
wtfc	Who The f**k Cares
wtfb	what the f**k b***h
wtharud	what the heck are you doing
wtfg	What the f**king god
wtfe	What The f**k Ever
wdywtd	what do you want to do
wthau	who the hell are you
welc	welcome
wys	wow you're stupid
witwu	who is there with you
wtbd	what's the big deal
wyp	what's your problem?
wthay	who the hell are you
wdydt	why do you do that
wugowm	will you go out with me
wyd	what are you doing
wyc	will you come
wyn	What's your name
wym	What You Mean?
wdywtta	what do you want to talk about
w.o.w	World of Warcraft
w.e	Whatever
wwyd2m	what would you do to me
wtfever	what the f**k ever
wmgl	wish me good luck
wyauimg	Why you all up in my grill?
wtmfh	what the mother f**king hell
wogs	waste of good sperm
wuwtab	what do you want to talk about
weg	wicked evil grin
wdyl	who do you like
wdutom	what do you think of me
wen	when
wan2tlk	Want to talk
wev	Whatever
wtfiup	what the f**k is your problem
wttp	want to trade pictures?
wht^	what up
wbs	write back soon
wbp	Welcome Back Partner
wby	what about you
wbb	will be back
whatcha	what are you
wlcm	welcome
www	world wide web
wiwhu	wish I was holding you
wtfayd	what the f**k are you doing
wwy	where were you
wgas	who gives a s**t
wlcb	welcome back
wwe	World Wrestling Entertainment
wwc	who would care
wthswm	want to have sex with me
w.o.w.	world of warcraft
wtfayt	why the f**k are you talking
wha	what?
wayta	what are you talking about
woum	what's on your mind
wwyt	What were you thinking
wthdydt	why the hell did you do that
wtfyb	what the f**k you b***h
wtfya	what the f**k you a**h**e
wtmtr	what's the matter
wazzup	what's up
wwycm	when will you call me
wats ^	whats up
wdtm	what does that mean
wtfru	what the f**k are you
whodi	friend
wutup	What's Up
wdidn	what do i do now
w/eva	whatever
wsop	world series of poker
wanna	want to
wolo	we only live once
wwt	what was that
wadr	with all due respect
wbu	what about you
wygowm	Will you go out with me
wrng	wrong
wtwm	what time are we meeting?
wai	what an idiot
wussup	What is up?
what^	what's up?
wad	without a doubt
wab	what a b***h
wochit	watch it
wrgad	who really gives a d**n
waz	what is
wrgaf	Who really gives a f**k?
waw	what a w***e
wuld	would
wau	what about you
wat	what
wtgds	way to go dumb s**t
witu	with you
witw	what in the world
wtfiyp	what the f**k is your problem
w\e	whatever
wbbs	will be back soon
wnt	want
wazz	what's
wutb	What are you talking about
wbagnfarb	would be a good name for a rock band
wtfigoh	what the f**k is going on here
whubut	what have you been up to
waz^	what's up?
whyd	What Have You Done
wuts	what is
whyb	where have you been
wat's^	Whats Up
w8am	wait a minute
wyhswm	would you have sex with me
wtful	What the f**k you loser
wtfruttd	what the f**k are you trying to do
wombat	waste of money, brains, and time
wtfiwwy	what the f**k is wrong with you
wtfiwwu	what the f**k is wrong with you
wrtg	writing
wamh	with all my heart
wgac	who gives a crap
wgaf	Who gives a f**k
wtityb	whatever, tell it to your blog
w012d	word
wdywd	what do you want to do?
wuzup	what's up
witfp	What is the f**king point
xcpt	except
xcept	except
xl	extra large
xgf	exgirlfriend
xyz	examine your zipper
xtra	extra
xd	extreme droll
xover	crossover
xmpl	example
xplaned	explained
xs	excess
xp	experience
xpect	expect
xtreme	extreme
xing	crossing
xoxo	hugs and kisses
xox	hugs and kisses
xit	Exit
xtc	ecstasy
xpt	except
x treme	extreme
xellent	excellent
xlnt	Excellent
xyzpdq	Examine Your Zipper Pretty Darn Quick
xor	hacker
xfer	transfer
xb36t	Xbox 360
xbf	ex-boyfriend
xbl	xbox live
xroads	crossroads
xoac	Christ on a crutch
xmas	christmas
ysic	why should I care
yea	yeah
ymmv	your mileage may vary
ysal	you suck at life
yomank	you owe me a new keyboard
youngin	young person
yer	you're
ymmd	You Made My Day
yew	you
yr	year
ydufc	Why do f**king care?
ywsyls	you win some you lose some
yuo	you
yme	why me
yayo	cocaine
ykw	You Know What
ygtbfkm	you've got to be f**king kidding me
yysw	yeah, yeah, sure, whatever
yh	yeah
yk	you kidding
yfg	you're f**king gay
ym	your mom
yfb	you f**king b*****d
ymg2c	your mom goes to college
ya	yeah
ye	yeah
yfi	you f**king idiot
ywywm	you wish you were me
ypmf	you pissed me off
ymrasu	Yes, My Retarded a** Signed Up
ys	you suck
yhgtbsm	You Have Got To Be Shitting Me
yu	You
yt	You there?
yw	you're welcome
ypmo	you piss me off
yrubm	why are you bugging me?
ynm	yes, no, maybe
yws	you want sex
ynk	you never know
yng	young
ysitm	your shirt is too small
yrusm	Why are you so mean
ynt	why not
yaafm	You Are A f**king Moron
ykywywm	you know you wish you were me
ynw	you know what
yall	you all
y'all	you all
ytis	You think I'm special?
yrms	You Rock My Socks
ythwudt	Why the hell would you do that
yolo	you only live once
yolt	you only live twice
yodo	you only die once
y w	you're welcome
ygtbk	you've got to be kidding
ytmnd	You're the man now, dog!
yiwtgo	Yes, I want to go private
yvfw	you're very f**king welcome
ydtm	You're dead to me
yasg	you are so gay
yasf	you are so funny
yty	why thank you
yki	You know it
ykn	you know nothing
ykm	You're killing me
yvw	you're very welcome
yatwl	you are the weakest link
ytm	you tell me
yasw	you are so weird
yhew	you
ytf	why the f**k
ytd	year to date
ykisa	Your knight in shining armor
ybya	you bet your a**
yarly	yeah really
ybbg	Your Brother By Grace
ywic	why would i care
ywia	You're welcome in advance
ypom	your place or mine
y2k	year 2000
yesh	yes
yup	yes
y2b	Youtube
yur	your
yhbt	you've been trolled
ylb	you little b***h
yduwtk	why do you want to know
yua	you ugly a**
y!a	yahoo answers
ytfwudt	why the f**k would you do that?
ywud	yo whats up dude
yooh	you
yaai	You are an idiot
yasan	You are such a nerd
yaaf	you are a f**
yid	yes, I do
y00	you
yim	yahoo instant messenger
yaw	you are welcome
yermom	your mother
yas	you are stupid
ymislidi	you make it sound like i did it
yctwuw	you can think what you want
ygrr	you got rick rolled
yag	you are gay
yaf	you're a f**
yru	why are you?
yaqw	You are quite welcome
ymiaw	your mom is a w***e
yust	why you say that
ywapom	you want a piece of me?
yhtbt	You Had To Be There
ygtbsm	You've got to be shitting me
ydpos	you dumb piece of s**t
y/o	Years Old
y/n	yes or no
yrs	years
ycmtsu	You Can't Make This s**t Up
ysm	you scare me
ysa	You Suck a**
ybs	you'll be sorry
ysf	you stupid f**k
yapa	yet another pointless acronym
yo'	your
ycntu	Why Cant You?
yss	you stupid s**t
ygtbkm	you got to be kidding me
ygtsr	you got that s**t right
ygg	you go girl
ysati	you suck at the internet
yasfg	you are so f**king gay
ygm	You Got Mail
yhpm	you have a private messge
ygp	you got  punked!
yatb	you are the best
yo	year old
ymgtc	Your Mom Goes To college
yn	why not
yaagf	you are a good friend
ykwya	you know who you are
yoy	why oh why
yor	your
yrsm	you really scare me
yafi	you're a f**king  idiot
yswnt	why sleep when not tired?
ykwim	you know what I mean
ywvm	you're welcome very much
yrsaf	You Are Such A Fool 
yrbk	Yearbook
ygpm	you've got a private message
ymbkm	you must be kidding me
ysoab	You son of a b***h
yrss	you are so sexy
yhl	you have lost
yhm	You have mail
ymfp	Your Most Favorite Person
yhf	you have failed
ycliu	You could look it up
y	why
yqw	you're quite welcome
zup	what's up?
zh	Zero Hour
z0mg	oh my god
zomfg	oh my f**king god
zig	cigarette
zomg	Oh my God
zomgzorrz	oh my god
z'omg	Oh my God
zoot	woohoo
zt	zoo tycoon
zot	Zero Tolerance
zex	sex
